author,Methodological research,Open source development,Clinical evidence generation,Open community data standards,paperCount
"Ryan, P",58,7,36,20,121
"Hripcsak, G",32,3,33,8,76
"Schuemie, M",38,6,19,10,73
"Park, R",9,5,26,15,55
"Reich, C",12,1,25,17,55
"Rijnbeek, P",15,8,21,8,52
"Suchard, M",24,4,24,0,52
"Kim, J",7,1,23,14,45
"You, S",7,2,23,13,45
"Prieto-Alhambra, D",7,1,24,4,36
"Shah, N",8,3,18,6,35
"Duarte-Salles, T",6,3,22,1,32
"Ostropolets, A",8,1,18,4,31
"Kostka, K",7,0,21,2,30
"Weng, C",13,3,2,10,28
"Matheny, M",2,1,20,4,27
"Kim, S",3,0,15,8,26
"Sedlmayr, M",2,4,0,20,26
"Falconer, T",7,1,16,1,25
"Madigan, D",17,1,5,1,24
"Sena, A",2,2,20,0,24
"Alshammari, T",5,0,17,1,23
"DuVall, S",2,0,17,4,23
"Reps, J",12,4,6,1,23
"Morales, D",2,0,20,0,22
"Natarajan, K",3,0,12,7,22
"Williams, A",6,0,9,7,22
"Nyberg, F",6,0,15,0,21
"Park, J",1,3,14,3,21
"Tatonetti, N",9,2,7,3,21
"Burn, E",2,1,13,4,20
"Lee, S",2,1,12,5,20
"Lynch, K",2,0,16,2,20
"Blacketer, C",0,1,13,5,19
"Kim, Y",2,0,14,3,19
"Banda, J",3,2,8,5,18
"Bathelt, F",1,2,1,14,18
"Golozar, A",3,0,14,1,18
"Spotnitz, M",4,0,13,1,18
"Kahn, M",2,0,6,9,17
"Reinecke, I",1,4,1,11,17
"Yoo, S",3,0,8,6,17
"Areia, C",3,0,13,0,16
"Boland, M",6,0,7,3,16
"Prats-Uribe, A",2,0,14,0,16
"Fernandez-Bertolin, S",2,1,11,1,15
"Huser, V",1,2,6,6,15
"Lai, L",5,0,10,0,15
"Posada, J",1,1,13,0,15
"Defalco, F",2,2,7,3,14
"Lee, D",0,1,10,3,14
"Minty, E",6,0,7,1,14
"Pratt, N",5,1,6,2,14
"Schilling, L",0,0,12,2,14
"Alghoul, H",0,0,13,0,13
"Jiang, G",1,2,0,10,13
"Peng, Y",0,2,0,11,13
"Shoaibi, A",3,0,10,0,13
"Williams, R",7,2,3,1,13
"Zhang, L",2,0,11,0,13
"Alser, O",0,0,12,0,12
"Chute, C",4,0,4,4,12
"Kim, K",1,0,8,3,12
"Lee, J",3,1,6,2,12
"Lee, K",0,0,11,1,12
"Voss, E",3,0,3,6,12
"Zoch, M",1,2,0,9,12
"Casajust, P",2,0,9,0,11
"Haendel, M",4,0,4,3,11
"Hartzema, A",7,0,1,3,11
"Henke, E",1,1,0,9,11
"Kim, H",0,0,8,3,11
"Lee, H",1,0,7,3,11
"Liu, H",5,2,1,3,11
"Makadia, R",1,1,7,2,11
"Pfaff, E",3,0,4,4,11
"Rao, G",4,1,6,0,11
"Stang, P",5,1,1,4,11
"Swerdel, J",6,2,3,0,11
"Xu, H",3,1,3,4,11
"Aragon, M",2,0,7,1,10
"Duke, J",2,3,2,3,10
"Kim, C",3,2,2,3,10
"Lane, J",1,0,9,0,10
"Li, X",6,1,2,1,10
"Roel, E",0,0,9,1,10
"Weaver, J",1,0,9,0,10
"Ahmed, W",0,0,9,0,9
"Baek, H",1,0,4,4,9
"Cho, J",0,1,5,3,9
"Dawoud, D",0,1,7,1,9
"Hardin, J",3,1,5,0,9
"Jonnagaddala, J",3,0,4,2,9
"Kolde, R",2,2,3,2,9
"Lee, Y",1,0,4,4,9
"Moffitt, R",4,0,4,1,9
"Park, S",0,0,5,4,9
"Park, Y",1,1,5,2,9
"Prokosch, H",0,5,0,4,9
"Recalde, M",0,0,8,1,9
"Seager, S",0,0,8,1,9
"Ta, C",4,1,2,2,9
"Vizcaya, D",1,1,7,0,9
"Zhang, X",2,0,4,3,9
"Butler, A",5,1,1,1,8
"Callahan, T",1,0,2,5,8
"Cho, S",1,0,2,5,8
"Choi, B",2,0,4,2,8
"Choi, J",2,0,3,3,8
"Fortin, S",3,0,4,1,8
"Gong, M",0,0,8,0,8
"Li, J",2,1,2,3,8
"Meeker, D",0,1,1,6,8
"Park, K",0,0,6,2,8
"Pistillo, A",0,0,7,1,8
"Seo, S",1,0,7,0,8
"Subbian, V",0,0,8,0,8
"Yu, Y",1,0,0,7,8
"Zhang, Y",2,1,3,2,8
"Arshad, F",5,0,2,0,7
"Bennett, T",3,0,2,2,7
"Chen, R",2,0,3,2,7
"Choi, S",0,0,2,5,7
"Denny, J",1,1,1,4,7
"Jeon, H",2,0,3,2,7
"Lamer, A",0,1,0,6,7
"McMurry, J",2,0,4,1,7
"Murphy, S",1,1,0,5,7
"Overhage, J",4,0,0,3,7
"Shah, K",0,0,7,0,7
"Shang, N",3,2,0,2,7
"Shin, W",0,0,7,0,7
"van der Lei, J",3,1,1,2,7
"Abrahao, M",2,0,4,0,6
"Boyce, R",1,1,1,3,6
"Bradwell, K",2,0,3,1,6
"Brown, J",0,1,0,5,6
"Bu, F",3,0,3,0,6
"Carroll, R",0,1,2,3,6
"Choi, Y",2,0,4,0,6
"Conover, M",1,0,5,0,6
"Davydov, A",0,0,3,3,6
"Dorr, D",1,0,3,2,6
"Dymshyts, D",0,0,1,5,6
"Girvin, A",3,0,2,1,6
"Hong, S",2,0,2,2,6
"Kaas-Hansen, B",2,0,4,0,6
"Kim, B",0,0,5,1,6
"Krumholz, H",1,0,5,0,6
"Li, Y",2,1,1,2,6
"Liaw, S",3,0,0,3,6
"Liu, C",2,0,1,3,6
"Man, K",1,0,3,2,6
"Mayer, M",1,1,2,2,6
"Mehta, P",0,0,6,0,6
"Nagy, P",1,0,3,2,6
"Oh, S",1,0,1,4,6
"Oja, M",1,1,2,2,6
"Park, D",1,1,2,2,6
"Sturkenboom, M",2,0,1,3,6
"Verhamme, K",2,1,3,0,6
"Wei, W",1,0,0,5,6
"Wong, I",1,1,2,2,6
"Belenkaya, R",1,0,0,4,5
"Bissell, M",2,0,1,2,5
"Blasini, R",0,5,0,0,5
"Chen, J",1,1,1,2,5
"Chen, Y",4,0,0,1,5
"Choi, I",0,0,2,3,5
"Chung, Y",0,0,5,0,5
"Coloma, P",3,0,0,2,5
"Denaxas, S",1,0,2,2,5
"Dudley, J",0,1,4,0,5
"Gabriel, D",1,0,1,3,5
"Gini, R",1,0,1,3,5
"Horban, S",0,0,4,1,5
"Hughes, N",1,1,2,1,5
"Hwang, H",0,0,3,2,5
"Jang, J",0,0,4,1,5
"Jung, C",0,0,5,0,5
"Khalid, S",0,1,3,1,5
"Kim, T",0,0,4,1,5
"Kolovos, S",0,0,5,0,5
"Lambert, C",0,0,4,1,5
"Lehmann, H",2,0,1,2,5
"Li, L",0,1,4,0,5
"Manna, A",3,0,1,1,5
"Nishimura, A",1,0,4,0,5
"Ong, T",0,0,4,1,5
"Pacheco, J",1,2,0,2,5
"Palchuk, M",1,0,1,3,5
"Papez, V",1,0,2,2,5
"Park, C",0,0,3,2,5
"Park, M",1,0,2,2,5
"Ramírez-Anguita, J",1,1,2,1,5
"Rasmussen, L",1,2,0,2,5
"Reisberg, S",1,2,0,2,5
"Reyes, C",0,0,4,1,5
"Rho, Y",1,0,3,1,5
"Shin, S",1,0,1,3,5
"Spratt, H",1,0,3,1,5
"Sun, Y",3,1,0,1,5
"Tan, E",1,0,4,0,5
"Vashisht, R",1,0,4,0,5
"Walden, A",1,0,2,2,5
"Wen, A",1,1,0,3,5
"Xie, J",0,0,5,0,5
"Yu, D",0,0,3,2,5
"Yuan, C",1,2,1,1,5
"Ahmadi, N",1,0,0,3,4
"Amor, B",2,0,1,1,4
"Amutha, A",0,0,4,0,4
"Anand, A",3,0,1,0,4
"Black, A",1,2,0,1,4
"Carter, W",0,0,4,0,4
"Casiraghi, E",1,0,2,1,4
"Català, M",0,1,2,1,4
"Cha, J",0,0,3,1,4
"Chang, D",0,0,4,0,4
"Cheong, J",1,0,2,1,4
"Choi, H",1,0,3,0,4
"Cimino, J",0,0,0,4,4
"Coleman, B",1,0,2,1,4
"Culhane, A",0,0,4,0,4
"D'Agostino, R",0,0,4,0,4
"Dabelea, D",0,0,4,0,4
"Daniel, C",0,0,0,4,4
"Delmestri, A",0,0,4,0,4
"DuMouchel, W",4,0,0,0,4
"Evans-Axelsson, S",1,0,3,0,4
"Fife, D",2,0,1,1,4
"Gagne, J",4,0,0,0,4
"Gruhl, M",0,1,0,3,4
"Gulden, C",0,4,0,0,4
"Gurley, M",0,0,0,4,4
"Hajagos, J",2,0,1,1,4
"Hamman, R",0,0,4,0,4
"He, Z",1,0,2,1,4
"Heider, P",1,2,0,1,4
"Hockett, C",0,0,4,0,4
"Hong, N",1,1,0,2,4
"Im, Y",0,0,2,2,4
"Isom, S",0,0,4,0,4
"Jensen, E",0,0,4,0,4
"Jeon, Y",0,0,3,1,4
"Jeong, C",0,0,2,2,4
"Jin, P",1,1,2,0,4
"Joo, H",0,0,0,4,4
"Kang, T",0,2,0,2,4
"Kent, S",0,0,3,1,4
"Kim, D",1,0,2,1,4
"Klann, J",0,1,0,3,4
"Ko, S",0,0,2,2,4
"Lawrence, J",0,0,4,0,4
"Luo, Y",1,2,0,1,4
"Maljković, F",1,1,2,0,4
"Mayer-Davis, E",0,0,4,0,4
"Meystre, S",1,2,0,1,4
"Mohan, V",0,0,4,0,4
"Moskovitch, R",4,0,0,0,4
"N'Dow, J",1,0,3,0,4
"Park, H",0,0,1,3,4
"Parrot, A",0,0,0,4,4
"Praveen, P",0,0,4,0,4
"Qureshi, N",2,0,1,1,4
"Reese, J",1,0,2,1,4
"Reeves, R",0,1,0,3,4
"Robinson, P",1,0,2,1,4
"Ruddy, K",1,0,0,3,4
"Ryu, B",2,0,0,2,4
"Song, S",0,0,4,0,4
"Steinbeisser, C",0,1,3,0,4
"Steyerberg, E",4,0,0,0,4
"Tandon, N",0,0,4,0,4
"Thurin, N",3,0,1,0,4
"Tian, Y",2,1,1,0,4
"Torre, C",1,0,3,0,4
"Trifirò, G",2,0,0,2,4
"Van Speybroeck, M",0,0,2,2,4
"Wang, Y",0,1,0,3,4
"Warner, J",1,0,0,3,4
"Weidner, J",0,0,1,3,4
"Weiskopf, N",0,0,2,2,4
"Welebob, E",3,0,0,1,4
"Wen, H",0,0,4,0,4
"Wilcox, A",0,1,2,1,4
"Wolfien, M",1,0,0,3,4
"Yang, C",3,1,0,0,4
"Yi, S",0,0,1,3,4
"Yoo, J",0,0,4,0,4
"Yoo, Y",3,0,1,0,4
"Yoon, J",0,0,3,1,4
"Zhou, X",2,0,0,2,4
"Zhou, Y",1,1,0,2,4
"Zhu, H",0,0,4,0,4
"Zhu, R",2,0,1,1,4
"Zong, N",1,0,0,3,4
"Zozus, M",0,1,0,3,4
"Abanos, S",0,0,1,2,3
"Abbott, T",0,0,3,0,3
"Adams, W",0,1,0,2,3
"Ahn, E",1,0,0,2,3
"Alloni, A",0,2,0,1,3
"Almeida, J",2,0,0,1,3
"Andryc, A",0,0,3,0,3
"Asiimwe, A",1,0,2,0,3
"Avillach, P",0,0,0,3,3
"Bardenheuer, K",0,0,2,1,3
"Bate, A",2,0,0,1,3
"Bellentani, M",0,0,1,2,3
"Benichou, J",3,0,0,0,3
"Benoit, B",1,0,0,2,3
"Bertolin, S",0,0,2,1,3
"Beuscart, J",0,0,0,3,3
"Bian, J",1,0,2,0,3
"Biedermann, P",0,0,2,1,3
"Bjartell, A",1,0,2,0,3
"Blau, H",1,0,2,0,3
"Blin, P",3,0,0,0,3
"Boeker, M",0,1,0,2,3
"Bremer, C",2,0,1,0,3
"Brooks, I",0,0,1,2,3
"Bräuner, K",3,0,0,0,3
"Butte, A",0,2,1,0,3
"Callahan, A",1,1,1,0,3
"Cappelletti, L",1,0,2,0,3
"Chazard, E",0,0,0,3,3
"Cornet, R",0,1,0,2,3
"Cornford, P",1,0,2,0,3
"De Keizer, N",0,1,0,2,3
"De Meulder, B",0,0,3,0,3
"Deer, R",0,0,3,0,3
"Dellavalle, R",0,0,3,0,3
"Doutreligne, M",0,0,0,3,3
"Droz-Perroteau, C",3,0,0,0,3
"Espinoza, J",0,1,0,2,3
"Fontana, T",1,0,2,0,3
"Gabetta, M",0,2,0,1,3
"Gall, W",0,0,0,3,3
"Gandaglia, G",1,0,2,0,3
"Ganslandt, T",0,0,0,3,3
"Ge, J",1,0,2,0,3
"Gruber, S",3,0,0,0,3
"Gögenur, I",3,0,0,0,3
"Han, M",0,0,3,0,3
"Harpaz, R",2,0,0,1,3
"Haug, M",1,1,0,1,3
"Hernandez-Boussard, T",2,0,1,0,3
"Hester, L",0,0,3,0,3
"Hijazy, A",0,0,3,0,3
"Jo, S",0,0,2,1,3
"John, L",0,0,3,0,3
"Johnson, S",1,0,0,2,3
"Jung, S",0,0,0,3,3
"Jödicke, A",0,0,2,1,3
"Kaduk, D",0,0,2,1,3
"Kallfelz, M",0,0,0,3,3
"Kang, S",1,0,2,0,3
"Karlebach, G",1,0,2,0,3
"Khare, R",0,1,0,2,3
"Kiefer, R",0,2,0,1,3
"Kim, G",1,0,1,1,3
"Kim, M",0,0,3,0,3
"Klazinga, N",0,0,1,2,3
"Knoll, C",1,1,0,1,3
"Kondylakis, H",0,0,0,3,3
"Kors, J",3,0,0,0,3
"Krastev, E",0,0,1,2,3
"Kwak, M",0,0,3,0,3
"Lai, J",1,0,2,0,3
"Lapi, F",0,0,1,2,3
"Lassalle, R",3,0,0,0,3
"Lee, E",0,0,3,0,3
"Liang, C",3,0,0,0,3
"Liu, L",0,0,3,0,3
"Liu, Q",2,0,0,1,3
"Liu, S",1,1,0,1,3
"Lorberbaum, T",2,0,1,0,3
"Lu, Y",0,0,2,1,3
"Madlock-Brown, C",1,0,0,2,3
"Maier, C",0,1,0,2,3
"Majeed, R",0,1,0,2,3
"Martinez Roldan, J",0,0,3,0,3
"Martinez, A",0,0,0,3,3
"Matcho, A",1,0,0,2,3
"McLeggon, J",2,0,1,0,3
"Miller, T",0,0,0,3,3
"Miotto, R",0,1,2,0,3
"Moinat, M",0,0,0,3,3
"Moore, J",2,0,0,1,3
"Moore, N",3,0,0,0,3
"Morris, M",1,0,1,1,3
"Mosseveld, M",0,0,2,1,3
"Mun, Y",0,0,3,0,3
"Newby, D",0,1,2,0,3
"Nguyen, P",0,0,1,2,3
"Nicoletti, R",1,0,2,0,3
"Niehaus, E",1,0,0,2,3
"Ohno-Machado, L",1,0,0,2,3
"Oliveira, J",1,0,0,2,3
"Ottman, R",1,0,2,0,3
"Pajusalu, M",1,1,0,1,3
"Paris, N",0,0,0,3,3
"Park, B",0,1,2,0,3
"Pasqua, A",0,0,1,2,3
"Pathak, J",0,2,0,1,3
"Phuong, J",0,0,0,3,3
"Polubriaginof, F",1,0,2,0,3
"Puttmann, D",0,1,0,2,3
"Pénichon, M",3,0,0,0,3
"Qian, Z",2,0,1,0,3
"Rassen, J",3,0,0,0,3
"Rhee, S",1,0,2,0,3
"Rinner, C",0,0,0,3,3
"Rivera, D",0,0,1,2,3
"Rogers, J",1,0,1,1,3
"Roh, J",0,0,0,3,3
"Rosen, A",3,0,0,0,3
"Ross, J",1,0,1,1,3
"Saltz, J",2,0,1,0,3
"Seo, W",0,0,3,0,3
"Seol, S",0,1,2,0,3
"Setoguchi, S",0,0,1,2,3
"Shervey, M",0,1,2,0,3
"Shin, H",2,0,1,0,3
"Sivesind, T",0,0,3,0,3
"Smith, D",1,0,2,0,3
"Song, J",0,0,3,0,3
"Song, W",1,0,1,1,3
"Stewart, H",1,0,1,1,3
"Sung, C",0,0,2,1,3
"Tcharaktchiev, D",0,0,1,2,3
"Thun, S",0,0,0,3,3
"Tsouchnika, A",3,0,0,0,3
"Tsuji, S",1,0,0,2,3
"Valentini, G",1,0,2,0,3
"Valveny, N",0,0,3,0,3
"Van Hemelrijck, M",2,0,1,0,3
"Van Zandt, M",1,0,2,0,3
"Vilo, J",0,2,0,1,3
"Waitman, L",0,0,0,3,3
"Wang, S",2,1,0,0,3
"Weill, A",3,0,0,0,3
"Willemse, P",1,0,2,0,3
"Woo, S",0,0,3,0,3
"Wooldridge, J",2,0,1,0,3
"Wu, Y",1,0,2,0,3
"Xu, Y",2,0,0,1,3
"Yang, J",1,0,2,0,3
"Yang, K",0,0,3,0,3
"Yoon, D",1,0,0,2,3
"Yoon, S",1,0,1,1,3
"Yoon, Y",1,0,0,2,3
"Youngerman, B",1,0,2,0,3
"Zhang, S",0,1,1,1,3
"Zhou, J",0,0,2,1,3
"Zhuk, O",0,0,3,0,3
"de Lusignan, S",0,0,1,2,3
"de Maeztu, G",0,0,3,0,3
"van Bochove, K",0,1,2,0,3
"van Sandijk, S",0,0,1,2,3
"Abedtash, H",0,0,2,0,2
"Adekkanattu, P",0,2,0,0,2
"Agnew, J",0,0,0,2,2
"Ahn, S",0,0,2,0,2
"Al-Shukri, S",0,1,0,1,2
"Alberga, A",0,0,2,0,2
"Albers, D",2,0,0,0,2
"Ancker, J",0,2,0,0,2
"Andre, J",0,0,0,2,2
"Anzalone, A",0,0,1,1,2
"Argyriou, G",1,0,1,0,2
"Asselbergs, F",0,0,0,2,2
"Austin, C",1,0,1,0,2
"Baghal, A",0,1,0,1,2
"Bakhshi-Raiez, F",0,0,0,2,2
"Bang, C",0,0,2,0,2
"Barbarini, N",0,2,0,0,2
"Barletta, V",0,0,1,1,2
"Bartos, M",0,0,0,2,2
"Bauck, A",0,0,0,2,2
"Baxter, R",0,0,0,2,2
"Baxter, S",0,0,0,2,2
"Beaton, M",0,0,1,1,2
"Becich, M",0,1,0,1,2
"Beggs, J",0,0,0,2,2
"Berlin, J",2,0,0,0,2
"Bernarding, J",0,0,0,2,2
"Beyer, K",1,0,1,0,2
"Bhattacharjee, T",0,0,0,2,2
"Blaisure, J",0,0,0,2,2
"Bonù, M",0,0,2,0,2
"Boo, D",0,0,1,1,2
"Borghetti, P",0,0,2,0,2
"Bosca, D",0,0,1,1,2
"Bosma, G",0,0,2,0,2
"Bowring, M",0,0,2,0,2
"Boyle, D",0,0,0,2,2
"Bracons Cucó, G",0,0,0,2,2
"Bradley, D",0,0,0,2,2
"Brand, M",0,0,1,1,2
"Brandt, E",0,0,0,2,2
"Brandt, P",0,2,0,0,2
"Brash, J",0,0,2,0,2
"Breant, S",0,0,0,2,2
"Briganti, A",0,0,2,0,2
"Burkard, T",0,0,1,1,2
"Byford, R",0,0,1,1,2
"Byrd, J",1,0,1,0,2
"Cai, C",0,0,1,1,2
"Campi, R",0,0,2,0,2
"Campion, T",0,0,0,2,2
"Caparrós-Redondo, M",0,0,0,2,2
"Carceller, H",0,0,0,2,2
"Carini, S",1,0,0,1,2
"Carrell, D",1,0,0,1,2
"Carus, J",1,0,0,1,2
"Castano, V",1,0,1,0,2
"Ceusters, W",0,0,0,2,2
"Chai, Y",0,0,2,0,2
"Chakrabarti, S",2,0,0,0,2
"Chan You, S",0,0,2,0,2
"Chan, L",0,0,2,0,2
"Chang, T",0,0,1,1,2
"Chen, W",1,0,0,1,2
"Chen, X",0,0,1,1,2
"Chen, Z",1,0,0,1,2
"Cho, M",1,0,0,1,2
"Choe, S",2,0,0,0,2
"Choi, W",0,0,0,2,2
"Chuter, A",0,0,0,2,2
"Clausen, J",2,0,0,0,2
"Colborn, K",1,0,1,0,2
"Cook, M",0,0,2,0,2
"Crameri, K",0,0,0,2,2
"Cricelli, I",0,0,1,1,2
"Dal Co, G",0,0,1,1,2
"Datta, D",0,2,0,0,2
"Daza, J",0,0,2,0,2
"De La Iglesia-Vayá, M",0,0,0,2,2
"DeWitt, P",1,0,1,0,2
"Deans, K",0,0,0,2,2
"Defebvre, M",0,0,0,2,2
"Denham, A",1,0,1,0,2
"Denton, J",0,0,1,1,2
"Depas, N",0,0,0,2,2
"Dhruva, S",1,0,0,1,2
"Didden, E",0,0,1,1,2
"Dikilitas, O",1,0,0,1,2
"Dimitriadis, V",0,0,2,0,2
"Dobbins, N",0,1,0,1,2
"Dobson, R",0,0,0,2,2
"Dolan, L",0,0,2,0,2
"Domenech-Fernández, J",0,0,0,2,2
"Drakos, I",2,0,0,0,2
"Duan, R",2,0,0,0,2
"Duftschmid, G",0,0,0,2,2
"Dumontier, M",0,0,0,2,2
"Ebert, M",0,0,2,0,2
"Elbers, P",0,1,0,1,2
"Elhadad, N",0,1,0,1,2
"Elovici, Y",2,0,0,0,2
"Erpenbeck, M",0,1,0,1,2
"Essaid, S",0,0,0,2,2
"Evans, L",1,1,0,0,2
"Feng, Y",0,0,0,2,2
"Ficheur, G",0,0,0,2,2
"Fischer, P",0,1,0,1,2
"Fišter, K",0,0,2,0,2
"Fouladvand, S",1,0,1,0,2
"Fraboulet, C",0,0,2,0,2
"Franceschini, D",0,0,2,0,2
"Francesconi, P",0,0,1,1,2
"Frazier, R",0,2,0,0,2
"French, T",0,1,1,0,2
"Frid, S",0,0,0,2,2
"Friedman, C",2,0,0,0,2
"Gainer, V",1,0,0,1,2
"Galvan, Y",0,0,2,0,2
"Gao, J",2,0,0,0,2
"Gao, W",0,0,2,0,2
"García-García, F",0,0,0,2,2
"Garibaldi, B",1,0,1,0,2
"Garza, M",0,1,0,1,2
"Gebler, R",0,0,0,2,2
"Gentine, P",1,0,1,0,2
"Gersing, K",1,0,1,0,2
"Giangreco, N",0,2,0,0,2
"Glicksberg, B",0,2,0,0,2
"Goetz, K",0,0,1,1,2
"Gold, S",0,0,0,2,2
"Graber-Naidich, A",0,0,2,0,2
"Greenfield, J",0,0,0,2,2
"Greicius, M",0,0,2,0,2
"Griffon, N",0,0,0,2,2
"Guan, Y",0,0,2,0,2
"Guinney, J",1,0,1,0,2
"Gundler, C",1,0,0,1,2
"Guo, Y",0,2,0,0,2
"Gómez Rivas, J",1,0,1,0,2
"Gómez-Ádrian, J",0,0,0,2,2
"Gögenur, M",2,0,0,0,2
"Gött, R",0,0,0,2,2
"Günster, C",0,0,0,2,2
"Günther, A",0,1,0,1,2
"Haberson, A",0,0,0,2,2
"Hafeez, H",0,0,1,1,2
"Hague, C",0,0,1,1,2
"Hallinan, C",0,0,0,2,2
"Halvorsen, L",0,0,0,2,2
"Halvorson, A",0,0,2,0,2
"Hanauer, D",0,0,0,2,2
"Hanchrow, E",0,0,1,1,2
"Harle, C",0,0,2,0,2
"Harris, N",0,0,2,0,2
"Haverkamp, C",0,0,0,2,2
"Haynes, K",1,0,1,0,2
"He, X",0,0,2,0,2
"Herings, R",1,0,0,1,2
"Hilka, M",0,0,0,2,2
"Hill, E",1,0,1,0,2
"Hobbs, F",0,0,1,1,2
"Hochheimer, C",0,0,2,0,2
"Hohman, K",0,0,0,2,2
"Holmes, J",1,0,0,1,2
"Hong, Y",0,0,2,0,2
"Horcajada, J",0,0,2,0,2
"Hribar, M",0,0,1,1,2
"Hruby, G",1,1,0,0,2
"Hull, M",0,0,0,2,2
"Hulsen, T",0,0,2,0,2
"Humphreys, K",1,0,1,0,2
"Hwang, S",0,0,2,0,2
"Höning, G",0,0,0,2,2
"Ilatovskiy, A",0,0,0,2,2
"Imran Omar, M",1,0,1,0,2
"Iqbal, U",0,0,1,1,2
"Itzel, T",0,0,2,0,2
"Jackson, S",0,0,0,2,2
"Jacobs, J",0,0,0,2,2
"Jefferson, E",0,0,0,2,2
"Jeon, K",0,0,0,2,2
"Ji, H",0,0,0,2,2
"Jiang, X",0,0,1,1,2
"Jimenez, H",1,0,1,0,2
"Jin, H",0,0,2,0,2
"Jing, Y",0,0,2,0,2
"Johnson, K",0,1,1,0,2
"Joo, Y",0,0,1,1,2
"Joss, M",0,1,0,1,2
"Joy, M",0,0,1,1,2
"Kalokyri, V",0,0,0,2,2
"Kalra, D",0,0,0,2,2
"Kamijima, Y",0,0,1,1,2
"Kang, D",1,0,1,0,2
"Kang, M",1,0,0,1,2
"Kapsner, L",0,2,0,0,2
"Katsch, F",0,0,0,2,2
"Kavuluru, R",1,0,1,0,2
"Khera, R",0,0,2,0,2
"Khosla, S",0,0,2,0,2
"Kim, E",0,0,2,0,2
"Kim, I",0,0,2,0,2
"Kim, W",1,0,1,0,2
"Kimura, S",0,0,1,1,2
"Kingsbury, P",0,1,0,1,2
"Kiryluk, K",0,0,1,1,2
"Kiwuwa-Muyingo, S",0,0,0,2,2
"Kohler, J",0,0,2,0,2
"Korntheuer, R",0,0,0,2,2
"Kraus, E",0,0,0,2,2
"Kreiner, K",0,1,0,1,2
"Kremer, A",0,0,0,2,2
"Kubota, K",0,0,1,1,2
"Kullo, I",1,0,0,1,2
"Köhler, S",0,0,0,2,2
"Larsen, R",0,2,0,0,2
"Lau, W",0,0,2,0,2
"Laur, S",0,1,0,1,2
"Lauschensky, A",0,1,0,1,2
"Lavallee, M",1,1,0,0,2
"Le Carrour, T",0,0,2,0,2
"Le Guen, Y",0,0,2,0,2
"Lee, N",0,2,0,0,2
"Lenert, L",0,0,0,2,2
"Leprovost, D",0,0,0,2,2
"Leutner, L",0,0,0,2,2
"Levine, M",1,0,0,1,2
"Levitt, E",1,0,1,0,2
"Li, Z",0,1,1,0,2
"Lim, H",1,0,1,0,2
"Lin, V",2,0,0,0,2
"Lingren, T",1,0,0,1,2
"Lipori, G",0,0,2,0,2
"Liu, F",1,0,0,1,2
"Liu, M",1,1,0,0,2
"Liu, Y",0,0,2,0,2
"Liyanage, H",0,0,1,1,2
"Londhe, A",0,0,1,1,2
"Loomba, J",1,0,0,1,2
"Lozano-Rubí, R",0,0,0,2,2
"Lyu, T",2,0,0,0,2
"López-Güell, K",0,1,0,1,2
"Ma, Q",0,0,0,2,2
"Macho, P",0,2,0,0,2
"Madhu, S",0,0,2,0,2
"Magoc, T",0,0,2,0,2
"Magrini, S",0,0,2,0,2
"Mallipattu, S",1,0,1,0,2
"Mandadi, N",0,0,0,2,2
"Markus, A",2,0,0,0,2
"Marquardt, K",0,1,0,1,2
"Mate, S",0,2,0,0,2
"Mayer, C",0,0,0,2,2
"Mazzaglia, G",1,0,0,1,2
"McClay, J",0,0,0,2,2
"McKhann, G",1,0,1,0,2
"Melton, G",1,0,0,1,2
"Mentch, F",1,0,0,1,2
"Mercadé-Besora, N",0,0,2,0,2
"Michel-Backofen, A",0,1,0,1,2
"Miller, R",1,0,0,1,2
"Modre-Osprian, R",0,1,0,1,2
"Mohan, S",0,0,0,2,2
"Molinaro, A",2,0,0,0,2
"Moll, K",2,0,0,0,2
"Montell-Serrano, J",0,0,0,2,2
"Moon, J",0,0,1,1,2
"Mooney, S",0,1,1,0,2
"Mooses, K",0,1,0,1,2
"Morgan Stewart, H",1,0,1,0,2
"Morgan-Stewart, H",0,0,2,0,2
"Moride, Y",2,0,0,0,2
"Morris, A",0,0,0,2,2
"Morris, C",0,0,0,2,2
"Moussa, M",0,0,0,2,2
"Mui, J",0,0,0,2,2
"Mungall, C",0,0,2,0,2
"Murray, G",1,1,0,0,2
"Muschelli, J",1,0,1,0,2
"Nadal-Almela, S",0,0,0,2,2
"Nair, V",2,0,0,0,2
"Nam, S",0,0,2,0,2
"Nassirian, A",0,1,0,1,2
"Natsiavas, P",0,0,2,0,2
"Nestor, J",0,0,0,2,2
"Neugut, A",1,0,1,0,2
"Neumann, A",1,0,1,0,2
"Neururer, S",0,1,0,1,2
"Nissim, N",2,0,0,0,2
"Nordeng, H",0,0,2,0,2
"Norén, G",0,1,0,1,2
"Oliver-Garcia, E",0,0,0,2,2
"Oskotsky, B",0,2,0,0,2
"Paeng, J",0,0,1,1,2
"Pang, C",1,0,0,1,2
"Parhi, P",1,0,1,0,2
"Park, T",0,0,2,0,2
"Park, W",0,0,0,2,2
"Pasquale, M",2,0,0,0,2
"Pastor Duran, X",0,0,0,2,2
"Patel, L",0,0,0,2,2
"Patterson, J",1,0,0,1,2
"Payralbe, S",0,0,0,2,2
"Pedersen, L",1,0,0,1,2
"Peissig, P",1,0,0,1,2
"Pellegrino, F",0,0,2,0,2
"Pfeifer, B",0,1,0,1,2
"Pfohl, S",1,0,1,0,2
"Pihoker, C",0,0,2,0,2
"Pletcher, M",0,0,2,0,2
"Popoff, B",0,0,0,2,2
"Prinsen, P",0,0,2,0,2
"Prud'hommeaux, E",0,0,0,2,2
"Puente, D",0,0,2,0,2
"Racoosin, J",2,0,0,0,2
"Rajwa, P",1,0,1,0,2
"Raventós, B",0,1,0,1,2
"Remmers, S",1,0,1,0,2
"Rhee, H",0,0,2,0,2
"Ribal, M",1,0,1,0,2
"Roberto, G",0,0,0,2,2
"Roh, Y",0,0,2,0,2
"Roobol, M",1,0,1,0,2
"Rosenberg, M",1,0,1,0,2
"Rouhizadeh, M",0,1,0,1,2
"Rudrapatna, V",0,2,0,0,2
"Rueda, M",0,1,0,1,2
"Ruhnke, T",0,0,0,2,2
"Rusanov, A",1,1,0,0,2
"Russell, S",1,0,1,0,2
"Ryoo, H",0,0,1,1,2
"Saborit-Torres, J",0,0,0,2,2
"Sathappan, S",0,0,1,1,2
"Sauer, B",2,0,0,0,2
"Schneider, H",0,2,0,0,2
"Schreier, G",0,1,0,1,2
"Schuff, R",0,0,2,0,2
"Schuler, A",1,0,1,0,2
"Schüttler, J",0,0,0,2,2
"Sen, A",2,0,0,0,2
"Seneviratne, M",2,0,0,0,2
"Serre, P",0,0,0,2,2
"Shahar, Y",2,0,0,0,2
"Shahn, Z",1,0,1,0,2
"Sharma, D",0,0,0,2,2
"Shea, S",0,0,2,0,2
"Sheikh, A",0,0,0,2,2
"Shin, D",1,0,0,1,2
"Sholle, E",0,1,0,1,2
"Si, Y",0,0,0,2,2
"Siapos, A",0,0,1,1,2
"Silverstein, J",0,1,0,1,2
"Sim, I",1,0,0,1,2
"Singh, B",0,0,0,2,2
"Singh, J",0,0,2,0,2
"Smith, E",0,0,2,0,2
"Snijder, R",0,0,2,0,2
"Soares, A",0,0,0,2,2
"Sohn, J",0,0,0,2,2
"Sohrabi, K",0,1,0,1,2
"Son, S",0,0,2,0,2
"Spoden, M",0,0,0,2,2
"Stewart, L",0,1,1,0,2
"Storf, H",0,0,0,2,2
"Stöhr, M",0,0,0,2,2
"Su, C",0,0,1,1,2
"Suehs, B",2,0,0,0,2
"Sun, H",0,0,0,2,2
"Sung, J",0,0,2,0,2
"Tak, Y",0,0,1,1,2
"Tavernier, B",0,0,0,2,2
"Taylor, A",0,0,0,2,2
"Teufel, A",0,0,2,0,2
"Thangaraj, P",0,2,0,0,2
"Thomas, J",0,0,2,0,2
"Tiwari, P",1,0,1,0,2
"Todd, J",0,0,0,2,2
"Tong, J",2,0,0,0,2
"Tran, D",0,0,2,0,2
"Trinh, N",0,0,2,0,2
"Tsafnat, G",0,0,0,2,2
"Twagirumukiza, M",0,0,0,2,2
"Vawdrey, D",1,0,1,0,2
"Verloop, D",0,0,0,2,2
"Viernes, B",0,0,0,2,2
"Vilar, S",2,0,0,0,2
"Visweswaran, S",0,0,0,2,2
"Volpe, S",0,0,2,0,2
"Walbech, J",2,0,0,0,2
"Waldman, G",1,0,1,0,2
"Waltemath, D",0,0,0,2,2
"Walters, K",0,0,0,2,2
"Walunas, T",1,0,0,1,2
"Wang, F",0,2,0,0,2
"Wang, J",0,1,1,0,2
"Wang, L",0,1,1,0,2
"Wang, X",0,0,1,1,2
"Wang, Z",0,0,2,0,2
"Ward, R",0,0,0,2,2
"Weatherston, D",0,0,0,2,2
"Wiest, I",0,0,2,0,2
"Wiley, K",1,0,0,1,2
"Williams, J",0,1,1,0,2
"Xu, Z",0,2,0,0,2
"Yang, Y",0,0,1,1,2
"Yao, L",0,0,0,2,2
"Yimer, B",0,0,2,0,2
"Yin, C",0,0,2,0,2
"Yoo, I",0,0,1,1,2
"Yoon, E",0,0,0,2,2
"Younes, K",0,0,2,0,2
"Zambarano, B",0,0,0,2,2
"Zampino, E",0,1,0,1,2
"Zeng, C",0,1,0,1,2
"Zhan, S",0,0,0,2,2
"Zhang, Q",0,0,2,0,2
"Zhang, R",0,0,0,2,2
"Zhou, T",1,1,0,0,2
"Zhu, Y",0,0,1,1,2
"Zuo, X",0,0,0,2,2
"de Groot, R",0,1,0,1,2
"de Ridder, M",0,1,0,1,2
"de Wilde, M",0,0,2,0,2
"Abad López, P",1,0,0,0,1
"Abajian, H",0,1,0,0,1
"Abajian, M",0,1,0,0,1
"Abend, A",0,0,1,0,1
"Abeysinghe, R",0,0,0,1,1
"Abou-Arab, O",0,0,0,1,1
"Abrams, C",0,0,0,1,1
"Abu Attieh, H",0,1,0,0,1
"Abu-El-Rub, N",0,1,0,0,1
"Acharya, N",0,0,0,1,1
"Achtman, A",0,0,1,0,1
"Acker, T",0,0,0,1,1
"Adam, T",0,0,0,1,1
"Adejumo, S",0,0,0,1,1
"Adelman, M",0,0,1,0,1
"Afzal, M",0,0,0,1,1
"Ahmad, F",0,1,0,0,1
"Ahmed, S",0,0,1,0,1
"Ahmedani, B",0,0,1,0,1
"Ahonen-Bishopp, A",0,0,0,1,1
"Aickelin, U",1,0,0,0,1
"Aizenstein, H",0,0,1,0,1
"Akbari, A",0,0,0,1,1
"Akinyemi, O",0,0,1,0,1
"Alavere, H",0,0,0,1,1
"Alba, P",0,0,0,1,1
"Alberti, A",0,0,1,0,1
"Ali, S",0,0,1,0,1
"Alkasab, T",0,0,0,1,1
"Allakhverdiiev, E",1,0,0,0,1
"Allou, N",0,0,0,1,1
"Allyn, J",0,0,0,1,1
"Alnofal, F",0,0,0,1,1
"Alonso, J",0,1,0,0,1
"Alrwisan, A",0,0,0,1,1
"Altun, F",0,1,0,0,1
"Amadi, D",0,0,0,1,1
"Amigo, F",0,1,0,0,1
"Amin, M",0,0,1,0,1
"Amin, R",0,0,0,1,1
"Aminorroaya, A",0,0,1,0,1
"Amirthalingam, G",0,0,1,0,1
"Ammar, N",1,0,0,0,1
"Amrollahi, F",1,0,0,0,1
"An, M",1,0,0,0,1
"Anand, S",0,0,0,1,1
"Anderson, K",0,0,0,1,1
"Anderson, W",0,0,1,0,1
"Andreescu, C",0,0,1,0,1
"Ang, P",0,0,0,1,1
"Angyan, P",0,1,0,0,1
"Annas, P",0,0,1,0,1
"Ansell, D",0,0,0,1,1
"Antognoni, P",0,0,1,0,1
"Antonescu, C",1,0,0,0,1
"Antony, B",1,0,0,0,1
"Apfel-Starke, J",0,0,0,1,1
"Aran, D",1,0,0,0,1
"Araujo, S",0,0,0,1,1
"Arensman, E",0,1,0,0,1
"Argenziano, M",0,0,1,0,1
"Ariosa, R",0,0,0,1,1
"Arlett, P",0,0,0,1,1
"Aronson, J",1,0,0,0,1
"Aruch, D",1,0,0,0,1
"Asch, S",1,0,0,0,1
"Ashish, N",0,0,0,1,1
"Avilés-Jurado, F",0,0,1,0,1
"Bacry, E",1,0,0,0,1
"Badgeley, M",0,1,0,0,1
"Bae, W",0,0,1,0,1
"Baek, R",0,0,0,1,1
"Bahati, O",0,0,0,1,1
"Bahroos, N",0,1,0,0,1
"Bailey, C",0,1,0,0,1
"Baillie, I",0,0,0,1,1
"Baillie, J",0,0,0,1,1
"Bak, S",0,0,1,0,1
"Baker, C",0,0,0,1,1
"Bakken, S",0,0,1,0,1
"Balcaen, T",0,0,0,1,1
"Balharry, D",0,0,0,1,1
"Banerjee, J",1,0,0,0,1
"Bang, J",0,0,1,0,1
"Banokina, T",0,0,0,1,1
"Bansal, A",0,0,0,1,1
"Barapatre, S",0,1,0,0,1
"Barbieri, J",0,0,1,0,1
"Barboza, C",0,1,0,0,1
"Barnett, D",0,0,0,1,1
"Barraca, J",1,0,0,0,1
"Barreto, M",0,0,0,1,1
"Bartels, S",0,0,0,1,1
"Bartlett, V",1,0,0,0,1
"Barton, A",0,1,0,0,1
"Bartschke, A",0,0,0,1,1
"Bartunek, J",1,0,0,0,1
"Barzi, F",0,0,1,0,1
"Bashir, A",0,0,0,1,1
"Bastarache, L",0,0,0,1,1
"Bastian, G",0,1,0,0,1
"Batch, A",0,0,0,1,1
"Bates, C",0,0,1,0,1
"Baudis, M",0,0,0,1,1
"Bauer-Mehren, A",1,0,0,0,1
"Baumgartner, M",0,1,0,0,1
"Baumgartner, W",0,0,0,1,1
"Bazakou, S",0,0,0,1,1
"Beaulieu-Jones, B",0,0,0,1,1
"Beccia, A",0,1,0,0,1
"Beck, T",0,0,0,1,1
"Bedrick, S",0,1,0,0,1
"Bedston, S",0,0,0,1,1
"Begum, S",0,1,0,0,1
"Behrens, M",0,1,0,0,1
"Bel, E",0,0,0,1,1
"Belbin, G",0,0,1,0,1
"Beles, M",1,0,0,0,1
"Bell, D",0,0,0,1,1
"Bellamine, A",0,0,0,1,1
"Bellas, L",0,0,0,1,1
"Bellasi, A",0,0,0,1,1
"Bellazzi, R",0,0,0,1,1
"Belmans, L",0,0,1,0,1
"Beltramo, G",0,0,1,0,1
"Benoit, V",0,0,0,1,1
"Benscoter, D",0,0,0,1,1
"Beran, M",0,0,0,1,1
"Berger, F",0,0,0,1,1
"Bergquist, T",1,0,0,0,1
"Bermejo, I",0,0,0,1,1
"Bernal, J",0,0,0,1,1
"Bernaux, M",0,0,0,1,1
"Berni, R",0,0,0,1,1
"Bernstam, E",0,0,0,1,1
"Berret, E",0,0,0,1,1
"Berti-Equille, L",1,0,0,0,1
"Bertoch, D",0,0,0,1,1
"Bertolini, G",1,0,0,0,1
"Bertolone, D",1,0,0,0,1
"Bertz, J",0,0,1,0,1
"Best, J",0,0,0,1,1
"Bethusamy, S",0,0,0,1,1
"Bey, R",0,0,0,1,1
"Beyan, O",0,0,0,1,1
"Beyer, S",0,0,0,1,1
"Bhanvadia, S",0,0,0,1,1
"Bhargav, M",0,1,0,0,1
"Bhatia, A",0,0,1,0,1
"Bhullar, H",0,0,0,1,1
"Bianchini, E",0,0,0,1,1
"Bieber, R",0,0,0,1,1
"Bigger, J",1,0,0,0,1
"Bikdeli, B",0,0,1,0,1
"Binder, H",0,0,0,1,1
"Birced, I",0,0,0,1,1
"Birch, R",0,0,0,1,1
"Bird, S",0,0,1,0,1
"Birhanu, M",0,0,0,1,1
"Birlie, B",0,0,1,0,1
"Birungi, F",0,0,0,1,1
"Bizimana, C",0,0,0,1,1
"Bjureberg, J",0,1,0,0,1
"Black, R",0,1,0,0,1
"Black, S",0,0,1,0,1
"Blagec, K",0,0,1,0,1
"Blay, J",0,0,1,0,1
"Boerries, M",0,0,0,1,1
"Bogaerts, E",1,0,0,0,1
"Bohm, A",0,1,0,0,1
"Boiten, J",1,0,0,0,1
"Bompelli, A",0,0,0,1,1
"Bonadt, K",0,0,0,1,1
"Bonhoeffer, J",1,0,0,0,1
"Booth, D",0,0,0,1,1
"Borkowetz, A",0,0,1,0,1
"Bosari, S",0,0,0,1,1
"Bosco, C",1,0,0,0,1
"Boudis, F",0,1,0,0,1
"Bourgeois, A",0,0,0,1,1
"Bouvy, J",0,0,0,1,1
"Bouzillé, G",0,0,0,1,1
"Bove, A",0,0,0,1,1
"Boxwala, A",0,0,0,1,1
"Boyer, L",0,0,1,0,1
"Boyle, J",0,0,1,0,1
"Boyle, K",0,0,1,0,1
"Bradford, R",0,0,0,1,1
"Branda, M",0,0,1,0,1
"Brasen, J",0,0,1,0,1
"Brat, G",0,0,0,1,1
"Brauer, R",0,0,0,1,1
"Braunstein, M",0,1,0,0,1
"Bray, B",0,1,0,0,1
"Breeze, T",0,0,0,1,1
"Briggs, J",0,0,1,0,1
"Britt, B",0,1,0,0,1
"Britten, C",1,0,0,0,1
"Brobert, G",0,0,1,0,1
"Bron, E",0,0,0,1,1
"Brookes, A",0,0,0,1,1
"Brooks, A",0,0,0,1,1
"Brooks, J",1,0,0,0,1
"Brophy, J",0,0,1,0,1
"Brouwer, E",1,0,0,0,1
"Brown, A",0,0,1,0,1
"Bruandet, A",0,1,0,0,1
"Bruce, S",0,0,1,0,1
"Brunelli, L",0,1,0,0,1
"Bruni, A",0,0,1,0,1
"Bucalo, M",0,0,0,1,1
"Buchowicz, K",0,1,0,0,1
"Buesgens, N",1,0,0,0,1
"Buglione, M",0,0,1,0,1
"Bui, M",0,0,1,0,1
"Bulut, M",1,0,0,0,1
"Bunker, D",0,0,0,1,1
"Bunnell, H",0,0,1,0,1
"Burgun, A",0,0,0,1,1
"Burke, B",0,0,0,1,1
"Burns, A",0,0,0,1,1
"Burns, F",0,0,0,1,1
"Burrows, E",0,0,0,1,1
"Busch, D",0,0,0,1,1
"Bush, B",0,0,0,1,1
"Butler, C",0,0,1,0,1
"Buy, M",0,0,0,1,1
"Byeon, G",0,0,1,0,1
"Byttebier, G",0,0,1,0,1
"Byun, J",0,0,1,0,1
"Bönisch, C",0,0,0,1,1
"Cadenas Juanino, H",0,0,1,0,1
"Cadilhac, D",0,0,1,0,1
"Cai, B",0,0,0,1,1
"Cai, T",0,0,0,1,1
"Caldwell, J",0,0,0,1,1
"Calligan, M",0,0,0,1,1
"Campbell, B",1,0,0,0,1
"Campbell, H",0,0,0,1,1
"Campbell, W",0,0,0,1,1
"Canakis, A",0,0,1,0,1
"Candore, G",0,0,0,1,1
"Canham, S",1,0,0,0,1
"Cao, A",0,0,0,1,1
"Cappella, N",0,0,0,1,1
"Capurro, D",0,0,0,1,1
"Carencotte, R",0,0,0,1,1
"Carević, B",0,0,1,0,1
"Carlini, E",0,0,1,0,1
"Carmona, L",1,0,0,0,1
"Carnahan, R",1,0,0,0,1
"Carney, P",1,0,0,0,1
"Caroll, R",1,0,0,0,1
"Carpenter, A",0,0,0,1,1
"Carraccio, C",1,0,0,0,1
"Carragher, M",0,0,1,0,1
"Carvel, A",0,0,0,1,1
"Castro, V",0,0,0,1,1
"Catalano, G",0,0,1,0,1
"Cates, A",0,1,0,0,1
"Cats, D",0,0,0,1,1
"Caucheteux, C",0,0,0,1,1
"Caufield, J",1,0,0,0,1
"Cavanaugh, R",0,0,1,0,1
"Cave, A",0,0,0,1,1
"Caverzagie, K",1,0,0,0,1
"Cazzola, W",0,0,0,1,1
"Cepeda, M",1,0,0,0,1
"Chahed, H",0,0,0,1,1
"Chakravarty, A",1,0,0,0,1
"Chamberlain, A",0,0,0,1,1
"Champ, J",0,0,0,1,1
"Chan, E",0,0,1,0,1
"Chan, M",0,0,1,0,1
"Chandler, R",1,0,0,0,1
"Chang, H",1,0,0,0,1
"Chang, J",0,0,0,1,1
"Chang, S",0,0,1,0,1
"Chang, W",0,0,1,0,1
"Chapman, W",0,1,0,0,1
"Chard, T",0,0,0,1,1
"Chatburn, R",0,0,0,1,1
"Chatellier, G",0,0,0,1,1
"Chatzidionysiou, K",1,0,0,0,1
"Chaudhari, D",0,0,0,1,1
"Chen, C",0,0,1,0,1
"Chen, Q",0,0,1,0,1
"Cheng, A",0,0,1,0,1
"Cheng, F",1,0,0,0,1
"Cheng, M",1,0,0,0,1
"Cheng, X",1,0,0,0,1
"Chhokar, R",0,0,1,0,1
"Chi, Y",1,0,0,0,1
"Chia-Cheng Lai, E",0,0,1,0,1
"Chidgey, C",0,0,0,1,1
"Chilelli, A",0,0,1,0,1
"Chiovato, L",0,0,0,1,1
"Chitturi, S",0,0,1,0,1
"Cho, E",0,0,1,0,1
"Cho, W",0,0,1,0,1
"Cho, Y",0,0,1,0,1
"Choe, E",0,0,1,0,1
"Choi, K",0,0,1,0,1
"Choi, M",0,1,0,0,1
"Christensen, L",0,1,0,0,1
"Christian, N",0,0,0,1,1
"Christoph, J",0,0,0,1,1
"Chu, S",0,0,0,1,1
"Chun, A",0,0,0,1,1
"Chun, H",0,0,1,0,1
"Chun, I",0,0,1,0,1
"Chun, K",0,0,1,0,1
"Chung, J",0,0,1,0,1
"Chung, T",0,0,1,0,1
"Chung, W",0,0,0,1,1
"Chytas, A",0,0,1,0,1
"Clement, G",0,1,0,0,1
"Cohen, T",1,0,0,0,1
"Colaert, D",0,0,0,1,1
"Colahan, C",0,0,0,1,1
"Cole, C",0,0,0,1,1
"Collins, C",0,0,0,1,1
"Collins, J",0,0,0,1,1
"Collison-Farr, K",0,0,0,1,1
"Conde, S",0,1,0,0,1
"Connell, D",0,0,0,1,1
"Connellan, C",1,0,0,0,1
"Connors, C",0,0,1,0,1
"Constantinovici, N",0,0,1,0,1
"Contrino, S",1,0,0,0,1
"Conway, M",0,1,0,0,1
"Cook, S",0,0,0,1,1
"Coplan, P",0,0,0,1,1
"Copland, D",0,0,1,0,1
"Coppola, M",0,0,0,1,1
"Cormont, S",0,0,0,1,1
"Coronado, G",0,0,0,1,1
"Corpus, S",0,0,1,0,1
"Cossin, S",0,0,0,1,1
"Costa, V",1,0,0,0,1
"Costello, R",0,0,1,0,1
"Cotter, M",0,0,1,0,1
"Coudert, M",0,0,1,0,1
"Cox, S",0,0,0,1,1
"Craig, J",0,0,0,1,1
"Crandall, K",0,0,0,1,1
"Cremonesi, F",0,0,0,1,1
"Crew, K",0,0,1,0,1
"Crews, D",0,0,1,0,1
"Cricelli, C",0,0,0,1,1
"Crimmins, N",0,0,0,1,1
"Crochet, H",0,0,1,0,1
"Croner, R",0,1,0,0,1
"Cronin, R",0,0,1,0,1
"Crooks, M",0,0,0,1,1
"Crosslin, D",0,0,0,1,1
"Cruz, J",0,0,0,1,1
"Cuccu, Z",0,0,1,0,1
"Cuggia, M",0,0,0,1,1
"Cui, G",1,0,0,0,1
"Cui, L",0,0,0,1,1
"Culliford, D",0,0,1,0,1
"Cunningham, J",0,0,0,1,1
"Curtin, C",1,0,0,0,1
"Custers, I",1,0,0,0,1
"Cuticchia, J",0,1,0,0,1
"Dabrera, G",0,0,1,0,1
"Dahm, L",0,0,1,0,1
"Dai, Z",0,0,1,0,1
"Dalby, M",0,0,1,0,1
"Dale, L",0,0,0,1,1
"Daly, O",0,0,0,1,1
"Dandala, B",1,0,0,0,1
"Dang, T",0,0,0,1,1
"Daniar, M",0,0,0,1,1
"Danilović, A",0,1,0,0,1
"Dasher, P",0,0,1,0,1
"Daumke, P",0,0,0,1,1
"Davatzikos, C",0,1,0,0,1
"David, R",1,0,0,0,1
"Davidson, B",0,0,0,1,1
"Davidson, L",0,0,0,1,1
"Davies, B",0,0,0,1,1
"Davies, E",0,0,1,0,1
"Davies, S",0,0,0,1,1
"Davis, H",1,0,0,0,1
"Davis, M",0,1,0,0,1
"Dazzi, P",0,0,1,0,1
"De Roo, J",0,0,0,1,1
"De Vloed, B",0,0,0,1,1
"DeKlotz, C",0,0,1,0,1
"Deakyne Davies, S",0,0,0,1,1
"Dedié, A",0,0,0,1,1
"Dedman, D",0,0,1,0,1
"Dekermanjian, J",0,0,1,0,1
"Dekker, A",0,0,0,1,1
"Del Fiol, G",0,0,0,1,1
"Delanerolle, G",0,0,0,1,1
"Delaney, J",0,0,1,0,1
"Delitto, A",0,0,0,1,1
"Dell'Oca, I",0,0,1,0,1
"Demelius, L",0,1,0,0,1
"Deng, H",0,0,1,0,1
"Deppen, S",0,0,0,1,1
"Depraetere, K",0,0,0,1,1
"Desai, P",0,0,1,0,1
"Descamps, F",0,0,0,1,1
"Devkota, B",0,0,0,1,1
"Dewey, B",0,0,0,1,1
"Dexheimer, J",0,0,0,1,1
"Dexter, E",1,0,0,0,1
"Dhingra, L",0,0,1,0,1
"Di Angelantonio, E",0,0,0,1,1
"Di Muzio, N",0,0,1,0,1
"DiPalazzo, J",0,0,0,1,1
"Diallo, G",0,0,0,1,1
"Diallo, I",1,0,0,0,1
"Diaz Holgado, A",0,0,1,0,1
"Diaz, L",0,0,1,0,1
"Dickey, M",0,0,1,0,1
"Dierckx, R",1,0,0,0,1
"Dieterle, N",0,0,0,1,1
"Digan, W",0,0,0,1,1
"Ding, J",0,0,0,1,1
"Ding, K",1,0,0,0,1
"Ding, Y",0,1,0,0,1
"Dissemond, J",0,0,0,1,1
"Dixon, B",0,1,0,0,1
"Djaballah, K",0,0,1,0,1
"Djukanovic, R",0,0,0,1,1
"Dodsley, C",0,0,0,1,1
"Dohrn, N",1,0,0,0,1
"Dolan, B",0,0,0,1,1
"Donatini, A",0,0,1,0,1
"Doney, A",0,0,0,1,1
"Dong, F",0,0,1,0,1
"Dong, X",0,0,0,1,1
"Dongelmans, D",0,0,0,1,1
"Donsa, K",0,1,0,0,1
"Dorajoo, S",0,0,0,1,1
"Dorn, C",0,0,1,0,1
"Dorward, J",0,0,1,0,1
"Doshi, A",0,0,0,1,1
"Dowden, M",0,0,1,0,1
"Driessen, S",0,0,1,0,1
"Drozda, J",0,0,0,1,1
"Du, M",0,1,0,0,1
"Duarte-Sales, T",0,0,1,0,1
"Dubiel, J",0,0,0,1,1
"Dubois, R",1,0,0,0,1
"Dunscombe, R",0,0,0,1,1
"Durand, T",0,0,1,0,1
"Eavis, A",0,0,1,0,1
"Eckrich, D",0,0,0,1,1
"Egger, P",0,0,0,1,1
"Eid, S",0,0,1,0,1
"Eiff, M",1,0,0,0,1
"Eils, R",0,0,0,1,1
"Ekanayake, C",0,0,1,0,1
"El-Hay, T",1,0,0,0,1
"Elhussein, A",0,0,0,1,1
"Elkin, P",0,1,0,0,1
"Elkind, M",0,0,1,0,1
"Elliot, A",0,0,1,0,1
"Elliston, K",0,1,0,0,1
"Elmqvist, N",0,0,0,1,1
"Eltinge, S",0,0,0,1,1
"Embree, K",0,0,0,1,1
"Empey, P",0,0,1,0,1
"Ena, L",0,0,1,0,1
"Engelmann, K",0,0,0,1,1
"Erdogan, B",0,0,1,0,1
"Erfurt-Berge, C",0,0,0,1,1
"Esteve, L",0,0,0,1,1
"Ethier, J",0,1,0,0,1
"Etminan, M",0,0,1,0,1
"Eun, Y",0,0,1,0,1
"Ewbank, J",1,0,0,0,1
"Eyre, D",0,0,0,1,1
"Fabry, P",0,1,0,0,1
"Fakhouri, W",1,0,0,0,1
"Falgenhauer, M",0,0,0,1,1
"Farrell, A",0,0,0,1,1
"Farshid, S",0,0,0,1,1
"Farzaneh, S",0,0,0,1,1
"Fedorov, A",0,1,0,0,1
"Feher, M",0,0,1,0,1
"Feinstein, J",0,0,0,1,1
"Feng, M",0,0,0,1,1
"Feng, Q",0,0,1,0,1
"Feng, X",0,0,1,0,1
"Ferdynus, C",0,0,0,1,1
"Fernandez-Chas, M",1,0,0,0,1
"Ferner, R",1,0,0,0,1
"Fernández Bertolín, S",0,0,1,0,1
"Ferreira, F",0,0,1,0,1
"Ferrer, M",0,1,0,0,1
"Filippone, C",1,0,0,0,1
"Fillion-Robin, J",0,1,0,0,1
"Fischer, A",0,0,0,1,1
"FitzHenry, F",0,0,0,1,1
"Fleuren, L",0,1,0,0,1
"Flores-Ortiz, R",0,0,0,1,1
"Flygare, O",0,1,0,0,1
"Fodor, A",0,0,1,0,1
"Follett, R",0,0,0,1,1
"Folz, M",0,1,0,0,1
"Forbes, A",0,0,0,1,1
"Forrest, C",1,0,0,0,1
"Forsyth, T",0,0,0,1,1
"Fort, D",0,0,0,1,1
"Fortin, B",0,0,1,0,1
"Foster, A",0,0,1,0,1
"Foster, I",0,1,0,0,1
"Fotiadis, D",0,0,0,1,1
"Fraas, S",0,0,0,1,1
"Fradziak, M",0,0,0,1,1
"Frank, M",0,0,0,1,1
"Franzese, C",0,0,1,0,1
"Freburger, J",0,0,0,1,1
"Freeberg, M",1,0,0,0,1
"Frias, J",0,0,1,0,1
"Fridgeirsson, E",0,1,0,0,1
"Friedman, A",1,0,0,0,1
"Fritsch, H",0,0,0,1,1
"Fromont, L",0,0,0,1,1
"Fruchart, M",0,0,0,1,1
"Fuentes, L",0,1,0,0,1
"Fuhrmann, S",0,0,0,1,1
"Fulton, O",0,0,0,1,1
"Gacci, M",0,0,1,0,1
"Gacquer, W",0,0,0,1,1
"Gagnidze, G",0,0,0,1,1
"Gall, H",0,0,0,1,1
"Gallant, S",0,0,0,1,1
"Gallego, B",0,0,0,1,1
"Galstyan, G",0,0,1,0,1
"Gan, S",0,0,1,0,1
"Gansel, X",0,0,0,1,1
"Gao, S",0,0,0,1,1
"Garbe, E",0,0,0,1,1
"Garcelon, N",0,0,0,1,1
"Garcia Morales, M",0,0,1,0,1
"Garcia, N",0,0,0,1,1
"García Barrio, N",0,0,1,0,1
"Gardner, H",0,0,0,1,1
"Gargano, M",1,0,0,0,1
"Garibaldi, J",1,0,0,0,1
"Gasman, S",0,1,0,0,1
"Gates, K",0,1,0,0,1
"Gaudet-Blavignac, C",0,0,0,1,1
"Gavriilidis, G",0,0,1,0,1
"Gehlenborg, N",0,0,0,1,1
"Gentilin, S",0,1,0,0,1
"Gerardi, M",0,0,1,0,1
"Gertzog, M",0,0,0,1,1
"Gezgin, D",0,0,0,1,1
"Ghosh, D",0,0,1,0,1
"Ghumman, N",1,0,0,0,1
"Gibson, J",1,0,0,0,1
"Gierend, K",0,0,0,1,1
"Gierschner, C",0,0,0,1,1
"Gifford, A",0,0,0,1,1
"Gifkins, D",1,0,0,0,1
"Gil Rojas, J",0,0,0,1,1
"Gilbert, J",0,1,0,0,1
"Gilbert, Z",0,0,1,0,1
"Gilbertson, J",0,1,0,0,1
"Giles, T",0,0,0,1,1
"Gillberg, J",0,0,0,1,1
"Gillen, K",0,0,0,1,1
"Gillson, N",0,0,0,1,1
"Gilpin, G",0,0,1,0,1
"Giménez, A",0,1,0,0,1
"Girani, E",0,1,0,0,1
"Giubbolini, R",0,0,1,0,1
"Giuste, F",0,0,0,1,1
"Glauche, I",0,0,1,0,1
"Glowe, P",0,0,1,0,1
"Gobbel, G",0,1,0,0,1
"Godecke, E",0,0,1,0,1
"Goel, K",0,0,1,0,1
"Goel, R",0,0,0,1,1
"Goldstein, A",1,0,0,0,1
"Goldstein, D",0,0,1,0,1
"Goldstein, M",1,0,0,0,1
"Goldstein, T",0,1,0,0,1
"Golovko, G",0,0,0,1,1
"Golriz Khatami, S",0,0,0,1,1
"Gombar, S",0,1,0,0,1
"Gomez-Rivas, J",0,0,1,0,1
"Gonul, S",0,0,0,1,1
"Goodrich, C",0,1,0,0,1
"Gorbachev, A",0,0,0,1,1
"Gorse, J",0,0,0,1,1
"Gotz, D",0,0,0,1,1
"Gouripeddi, R",0,0,0,1,1
"Goyer, F",0,1,0,0,1
"Gradinger, T",0,0,0,1,1
"Gramfort, A",0,0,0,1,1
"Grammatikopoulou, M",0,0,1,0,1
"Grannis, S",0,1,0,0,1
"Gratton, J",0,0,0,1,1
"Gray, J",0,1,0,0,1
"Greaves, P",0,0,0,1,1
"Greco, C",0,0,1,0,1
"Green, L",1,0,0,0,1
"Greevy, R",0,0,1,0,1
"Gregory, A",0,0,0,1,1
"Grieve, G",0,0,0,1,1
"Griffier, R",0,0,0,1,1
"Griffiths, K",0,0,1,0,1
"Grisel, O",0,0,0,1,1
"Gruendner, J",0,1,0,0,1
"Grummt, S",0,0,0,1,1
"Gröber, P",0,0,0,1,1
"Gründner, J",0,0,0,1,1
"Guerin, J",0,0,0,1,1
"Guerin, P",0,0,1,0,1
"Guo, C",0,0,1,0,1
"Guo, G",0,0,0,1,1
"Guo, J",0,0,1,0,1
"Guo, L",0,0,0,1,1
"Gupta, A",0,0,1,0,1
"Gupta, S",0,0,0,1,1
"Gut, I",0,1,0,0,1
"Gutierrez, M",0,0,0,1,1
"Gutierrez-Sacristan, A",0,0,0,1,1
"Haam, S",0,0,0,1,1
"Haarbrandt, B",0,0,0,1,1
"Hadfield, A",0,0,0,1,1
"Haese, T",0,0,0,1,1
"Hakonarson, H",1,0,0,0,1
"Halfpenny, W",0,0,0,1,1
"Hall, C",0,0,0,1,1
"Hall, E",1,0,0,0,1
"Hall, I",0,0,0,1,1
"Hall, N",0,0,1,0,1
"Halpern, Y",0,1,0,0,1
"Hamerlijnck, D",0,0,0,1,1
"Hampton, J",0,0,0,1,1
"Han, C",0,0,1,0,1
"Han, J",0,0,0,1,1
"Han, K",0,0,0,1,1
"Han, O",0,0,0,1,1
"Han, S",0,0,1,0,1
"Han, Y",0,0,1,0,1
"Handler, S",0,0,0,1,1
"Hansen, R",1,0,0,0,1
"Haque, S",0,0,1,0,1
"Harding, R",1,0,0,0,1
"Hardy, D",0,0,0,1,1
"Hardy, N",0,0,0,1,1
"Harms, A",0,0,0,1,1
"Harnett, B",0,0,0,1,1
"Haro, J",0,0,1,0,1
"Harper, J",0,0,1,0,1
"Harrington, R",0,1,0,0,1
"Harris, D",0,1,0,0,1
"Hart, G",0,0,0,1,1
"Hartwig, M",1,0,0,0,1
"Harvey, S",0,0,1,0,1
"Hauben, M",1,0,0,0,1
"Hauger, R",0,0,1,0,1
"Hayati, S",0,0,1,0,1
"Hayes, J",0,0,1,0,1
"Hayn, D",0,1,0,0,1
"He, Y",0,0,1,0,1
"Heavner, S",0,0,1,0,1
"Hechtel, N",0,0,0,1,1
"Heckbert, S",1,0,0,0,1
"Hedenmalm, K",0,0,0,1,1
"Hees, H",0,0,0,1,1
"Heggermont, W",1,0,0,0,1
"Heidenreich, A",0,0,0,1,1
"Helfer, S",0,1,0,0,1
"Hemingway, H",0,0,0,1,1
"Henderson, A",0,1,0,0,1
"Hendricks, B",0,0,1,0,1
"Hens, D",1,0,0,0,1
"Heo, E",0,0,1,0,1
"Heo, J",0,0,1,0,1
"Heo, Y",0,0,0,1,1
"Herrera, J",0,0,0,1,1
"Herrera, R",0,0,1,0,1
"Herrick, C",0,1,0,0,1
"Herrmann, T",0,0,0,1,1
"Hersh, W",0,1,0,0,1
"Hesser, J",0,0,0,1,1
"Heudel, P",0,0,1,0,1
"Heuvelink, J",0,0,0,1,1
"Hewa, K",0,0,0,1,1
"Hewitt, K",0,0,0,1,1
"Hilton, C",0,0,0,1,1
"Hinojosa, E",0,0,0,1,1
"Hinton, W",0,0,0,1,1
"Hoang, U",0,0,1,0,1
"Hochheiser, H",0,0,0,1,1
"Hodder, S",0,0,1,0,1
"Hofer, S",0,0,1,0,1
"Hoffmann, K",0,0,0,1,1
"Hofmann-Apitius, M",0,0,0,1,1
"Hogarth, M",0,0,0,1,1
"Holleczek, B",1,0,0,0,1
"Holm, J",0,0,0,1,1
"Holmboe, E",1,0,0,0,1
"Holub, P",1,0,0,0,1
"Hopkins, S",0,0,0,1,1
"Horki, P",0,0,0,1,1
"Horswell, R",0,0,0,1,1
"Horvitz, E",1,0,0,0,1
"Hosokawa, P",0,0,0,1,1
"Hotopf, M",0,0,1,0,1
"Hottgenroth, A",1,0,0,0,1
"Hou, J",1,0,0,0,1
"Hou, L",0,0,0,1,1
"Houghtaling, J",0,0,0,1,1
"Howell, K",0,0,0,1,1
"Howsam, G",0,0,1,0,1
"Hoxha, J",1,0,0,0,1
"Hsu, J",0,0,0,1,1
"Hsu, M",0,0,0,1,1
"Huang, C",0,0,0,1,1
"Huang, K",0,0,0,1,1
"Huang, M",1,0,0,0,1
"Huang, N",0,0,0,1,1
"Huang, Z",0,0,1,0,1
"Hubbard, R",1,0,0,0,1
"Huber, A",0,0,0,1,1
"Hui, S",1,0,0,0,1
"Hume, A",0,0,0,1,1
"Hung, A",0,0,1,0,1
"Hung, P",1,0,0,0,1
"Hunger, M",0,0,1,0,1
"Hunt, C",0,0,1,0,1
"Hunter, L",0,0,0,1,1
"Huo, N",0,0,0,1,1
"Hurley, M",0,0,1,0,1
"Husain, S",0,0,0,1,1
"Hussein, R",0,0,0,1,1
"Husson, J",0,0,0,1,1
"Hwang, K",0,0,1,0,1
"Hwang, Y",1,0,0,0,1
"Hübner, U",0,0,0,1,1
"Hüsers, J",0,0,0,1,1
"Ibañez, L",1,0,0,0,1
"Ichihara, M",0,0,0,1,1
"Ide, J",0,0,1,0,1
"Im, M",0,0,1,0,1
"Inau, E",0,0,0,1,1
"Inberg, G",0,1,0,0,1
"Inglis, C",0,0,1,0,1
"Innocenti, F",1,0,0,0,1
"Inoue, J",0,0,0,1,1
"Ioannou, S",0,1,0,0,1
"Ionita-Laza, I",0,0,1,0,1
"Islam, S",0,0,0,1,1
"Israni, S",0,1,0,0,1
"Ivaldi, G",0,0,1,0,1
"Iyengar, S",0,1,0,0,1
"Jaarsma, E",0,0,0,1,1
"Jackson, A",0,0,0,1,1
"Jackson, T",0,0,0,1,1
"Jacobs, M",0,0,0,1,1
"Jacunski, A",1,0,0,0,1
"Jamil, M",0,0,0,1,1
"Jammerbund, B",0,1,0,0,1
"Jang, I",0,0,0,1,1
"Jang, M",0,0,0,1,1
"Jang, S",0,0,0,1,1
"Jang, W",0,0,1,0,1
"Jani, M",1,0,0,0,1
"Jannot, A",0,0,0,1,1
"Jansen, S",0,0,0,1,1
"Jansen, W",0,0,0,1,1
"Jean-Baptiste, L",0,0,0,1,1
"Jee, D",0,0,1,0,1
"Jeffery, K",0,0,0,1,1
"Jeon, J",0,0,1,0,1
"Jeon, S",0,0,0,1,1
"Jeong, E",0,0,0,1,1
"Jereczek-Fossa, B",0,0,1,0,1
"Jhaveri, K",0,0,1,0,1
"Ji, X",1,0,0,0,1
"Jiang, Q",1,0,0,0,1
"Jin, E",0,0,1,0,1
"Jin, K",0,0,1,0,1
"Jin, S",0,0,1,0,1
"Jing, S",0,0,1,0,1
"Jo, Y",0,0,1,0,1
"Johanns, O",1,0,0,0,1
"Johnston, J",0,0,0,1,1
"Joiner, E",1,0,0,0,1
"Jolley, S",0,0,1,0,1
"Jones, N",0,0,1,0,1
"Jones, S",1,0,0,0,1
"Jonsson, P",0,0,0,1,1
"Joopudi, V",1,0,0,0,1
"Jorm, L",0,0,0,1,1
"Jose, G",0,0,0,1,1
"Josefsson, A",0,0,1,0,1
"Jouhet, V",0,0,0,1,1
"Joy, G",0,0,0,1,1
"Jung, E",1,0,0,0,1
"Jung, H",0,0,1,0,1
"Jung, K",0,0,1,0,1
"Junior, E",0,0,0,1,1
"Kabakambira, J",0,0,0,1,1
"Kabano, I",0,0,0,1,1
"Kadengye, D",0,0,0,1,1
"Kadioglu, D",0,0,0,1,1
"Kahn, C",0,0,0,1,1
"Kalaw, F",0,0,0,1,1
"Kam, H",0,0,0,1,1
"Kamauu, A",0,0,0,1,1
"Kanbar, L",0,0,0,1,1
"Kandukuri, P",1,0,0,0,1
"Kang, B",0,0,0,1,1
"Kanjala, C",0,0,0,1,1
"Kao Yang, Y",0,0,1,0,1
"Kao, Y",0,0,0,1,1
"Karafin, M",0,0,0,1,1
"Karatzanis, I",0,0,0,1,1
"Karczewski, K",0,0,0,1,1
"Karim, H",0,0,1,0,1
"Karimkhani, C",0,0,1,0,1
"Karnes, J",0,0,1,0,1
"Karp, J",0,0,0,1,1
"Kasani, P",0,0,1,0,1
"Kashyap, M",1,0,0,0,1
"Kashyap, R",0,0,1,0,1
"Kasthurirathne, S",1,0,0,0,1
"Katalinic, A",1,0,0,0,1
"Kean, J",0,0,0,1,1
"Kelbert, P",0,0,0,1,1
"Kelechi, T",0,1,0,0,1
"Keller, M",0,0,0,1,1
"Keloth, V",0,0,0,1,1
"Kempf, E",0,0,0,1,1
"Kennedy, G",0,0,0,1,1
"Kenny, E",0,0,1,0,1
"Kent, D",1,0,0,0,1
"Kern, D",0,0,1,0,1
"Kern, I",0,0,1,0,1
"Kerr, W",0,0,0,1,1
"Kersten, O",0,0,0,1,1
"Kesztyüs, D",0,0,0,1,1
"Kesztyüs, T",0,0,0,1,1
"Khalilia, M",0,1,0,0,1
"Khan, A",0,0,0,1,1
"Khan, H",0,0,0,1,1
"Khanipov, K",0,0,0,1,1
"Kharrazi, H",0,0,0,1,1
"Khayter, M",0,0,0,1,1
"Khodaverdi, M",0,0,1,0,1
"Khoma, Y",1,0,0,0,1
"Khoshneshin, M",1,0,0,0,1
"Kieler, C",0,0,0,1,1
"Kimble, W",0,0,1,0,1
"Kinnaird, A",0,0,1,0,1
"Kiragga, A",0,0,0,1,1
"Kirby, J",0,0,1,0,1
"Kirchoff, K",0,0,0,1,1
"Kirkham, R",0,0,1,0,1
"Kirkwood, M",0,0,1,0,1
"Kizilaslan, B",0,1,0,0,1
"Klengel, C",0,0,0,1,1
"Klink, K",1,0,0,0,1
"Klopfenstein, S",0,0,0,1,1
"Kluetz, P",0,0,0,1,1
"Knaack, D",0,0,0,1,1
"Ko, G",0,0,1,0,1
"Ko, I",1,0,0,0,1
"Ko, Y",0,0,1,0,1
"Kodamullil, A",0,0,0,1,1
"Kohane, I",0,0,0,1,1
"Kopek, N",0,0,1,0,1
"Korf, B",0,0,1,0,1
"Korsik, V",0,0,0,1,1
"Kotik, D",0,0,1,0,1
"Kovachev, P",0,0,1,0,1
"Kowalski, C",0,0,0,1,1
"Krajenbrink, E",0,0,1,0,1
"Krantz, I",0,0,0,1,1
"Kraska, D",0,0,0,1,1
"Krasteva, R",0,0,0,1,1
"Kraus, S",0,1,0,0,1
"Krefting, D",0,0,0,1,1
"Krestan, S",0,0,0,1,1
"Kroes, J",0,0,0,1,1
"Krueger, R",0,0,0,1,1
"Krueger, S",0,0,0,1,1
"Ku, C",0,0,0,1,1
"Kuang, Z",1,0,0,0,1
"Kugler, J",0,0,1,0,1
"Kullamaa, L",1,0,0,0,1
"Kumar, V",0,0,1,0,1
"Kuppelwieser, S",0,0,0,1,1
"Kurki, S",0,0,1,0,1
"Kury, F",1,0,0,0,1
"Kurz, X",0,0,0,1,1
"Kwan, B",0,0,0,1,1
"Kwon, J",0,0,1,0,1
"Kwon, S",0,0,1,0,1
"Kwon, Y",0,0,1,0,1
"Kwong, A",1,0,0,0,1
"Kwong, M",0,0,0,1,1
"Kärcher, F",0,0,0,1,1
"Kümmel, M",0,1,0,0,1
"Künnapuu, K",0,1,0,0,1
"La Ferla, S",0,0,0,1,1
"Ladhani, S",0,0,0,1,1
"Lage-Rupprecht, V",0,0,0,1,1
"Laht, M",0,0,0,1,1
"Lai, E",0,0,0,1,1
"Laleci Erturkmen, G",0,0,0,1,1
"Lam, I",0,0,1,0,1
"Lambrecht, M",0,0,1,0,1
"Lamers, F",0,0,1,0,1
"Lang, L",0,0,0,1,1
"Lanzola, G",0,1,0,0,1
"Lara-Corrales, I",0,0,1,0,1
"Laraway, B",1,0,0,0,1
"Lasso, A",0,1,0,0,1
"Latorre Moreno, L",0,1,0,0,1
"Laudati, A",0,0,1,0,1
"Laufer, J",0,0,0,1,1
"Lavagna, J",0,0,0,1,1
"Lawlor, A",1,0,0,0,1
"Lawrence, E",0,0,0,1,1
"Lawrence-Archer, L",0,0,1,0,1
"LePendu, P",1,0,0,0,1
"Lea, D",0,0,0,1,1
"Leach, J",0,0,1,0,1
"Leal, I",0,0,0,1,1
"Leblanc, J",0,0,0,1,1
"Lee, A",0,0,0,1,1
"Lee, B",0,0,1,0,1
"Lee, C",0,0,0,1,1
"Lee, G",1,0,0,0,1
"Lee, I",0,0,1,0,1
"Lee, M",0,0,1,0,1
"Leeming, G",0,0,0,1,1
"Leese, P",1,0,0,0,1
"Lehne, M",0,0,0,1,1
"Leightley, D",0,0,1,0,1
"Leis, A",0,1,0,0,1
"Leist, I",0,1,0,0,1
"Lemaitre, G",0,0,0,1,1
"Lembke, A",0,0,1,0,1
"Lemmon, J",0,0,0,1,1
"Leung, C",0,0,1,0,1
"Levenson, M",1,0,0,0,1
"Levis, M",0,1,0,0,1
"Levra, N",0,0,1,0,1
"Li, F",0,0,0,1,1
"Li, K",0,0,1,0,1
"Li, M",0,0,1,0,1
"Li, R",1,0,0,0,1
"Lian Duan, L",1,0,0,0,1
"Liang, J",1,0,0,0,1
"Liao, C",0,0,0,1,1
"Liberman, D",0,0,0,1,1
"Ligi, K",0,1,0,0,1
"Lim, J",0,0,1,0,1
"Lim, S",0,0,0,1,1
"Lima, D",0,0,0,1,1
"Lin, A",0,0,0,1,1
"Lin, C",1,0,0,0,1
"Lin, H",0,0,0,1,1
"Lin, M",0,1,0,0,1
"Lin, X",0,0,1,0,1
"Linden, T",0,0,0,1,1
"Lindenmayer, G",0,0,1,0,1
"Liu, J",1,0,0,0,1
"Livartowski, A",0,0,0,1,1
"Logier, R",0,0,0,1,1
"Longmore, D",0,0,1,0,1
"Loomis, A",0,0,0,1,1
"Loperena-Cortes, R",0,0,1,0,1
"Lopez Bernal, J",0,0,1,0,1
"Lopez Montesinos, I",0,0,1,0,1
"Lopez, I",0,0,1,0,1
"Lorenz, S",0,0,0,1,1
"Lovestone, S",0,0,1,0,1
"Lovis, C",0,0,0,1,1
"Lozinski, G",0,0,0,1,1
"Lu, C",0,0,0,1,1
"Lu, S",0,0,0,1,1
"Lu, Z",0,1,0,0,1
"Lumbers, R",0,0,0,1,1
"Luo, C",1,0,0,0,1
"Luo, H",0,0,1,0,1
"Lupattelli, A",0,0,1,0,1
"Luxan, B",0,0,0,1,1
"Luzuriaga, K",0,0,0,1,1
"Lynch, J",0,0,0,1,1
"Lyons, R",0,0,0,1,1
"Lyu, K",0,1,0,0,1
"López-Rueda, A",0,0,0,1,1
"Lõo, M",0,0,0,1,1
"Ma, X",0,0,1,0,1
"MacDonald, B",0,1,0,0,1
"MacLeod, R",0,0,0,1,1
"Macdonald, C",0,0,0,1,1
"Machado, A",1,0,0,0,1
"Machnicki, G",1,0,0,0,1
"Machín, A",0,0,0,1,1
"Maclin, R",1,0,0,0,1
"Mahoney, K",1,0,0,0,1
"Maidlow, S",0,0,0,1,1
"Malbrain, M",0,0,1,0,1
"Malk, M",0,0,0,1,1
"Malone, D",0,0,1,0,1
"Malovini, A",0,0,0,1,1
"Mamidi, T",1,0,0,0,1
"Man, W",0,0,1,0,1
"Mandair, D",1,0,0,0,1
"Mandhadi, V",0,0,0,1,1
"Mandl, K",0,0,0,1,1
"Manion, F",0,1,0,0,1
"Manisty, C",0,0,0,1,1
"Mansfield, A",1,0,0,0,1
"Mansouri-Benssassi, E",0,0,0,1,1
"Manuwald, U",0,0,1,0,1
"Mao, C",0,0,0,1,1
"Maoyi, M",0,0,0,1,1
"Maple-Brown, L",0,0,1,0,1
"Marcilly, R",0,0,0,1,1
"Marcou, Q",1,0,0,0,1
"Maresca, G",0,0,1,0,1
"Margulis, A",0,0,1,0,1
"Marias, K",0,0,0,1,1
"Marinier, K",1,0,0,0,1
"Marino, M",1,0,0,0,1
"Markov, E",0,0,0,1,1
"Marks, P",0,0,0,1,1
"Marschollek, M",0,0,0,1,1
"Marshall, C",0,0,0,1,1
"Marshall, M",0,0,1,0,1
"Marteau, B",0,0,0,1,1
"Martel, P",0,0,0,1,1
"Marti, E",0,0,1,0,1
"Martin, B",0,0,0,1,1
"Martin, D",1,0,0,0,1
"Martin, J",0,0,0,1,1
"Martinez-Hernandez, E",0,0,1,0,1
"Martinez-Queipo, M",0,0,0,1,1
"Martufi, V",0,0,0,1,1
"Martínez-Sáez, O",0,0,0,1,1
"Mashkoor, M",1,0,0,0,1
"Masood, E",0,0,0,1,1
"Masuy, I",1,0,0,0,1
"Matacotta, J",0,0,1,0,1
"Matcham, F",0,0,1,0,1
"Matentzoglu, N",0,0,0,1,1
"Mateus, P",0,0,0,1,1
"Mathew, J",0,0,0,1,1
"Mathew, S",0,0,0,1,1
"Mathioudakis, N",0,0,1,0,1
"Mathé, E",0,0,1,0,1
"Matos, S",0,0,0,1,1
"Mayer, P",0,0,0,1,1
"Mayo, K",0,0,1,0,1
"Mayrhofer, M",1,0,0,0,1
"Mazzetti, S",0,0,0,1,1
"Mazzola, R",0,0,1,0,1
"McAllister, G",0,0,0,1,1
"McAuley, A",0,0,0,1,1
"McClure, R",0,0,0,1,1
"McCrimmon, R",0,0,1,0,1
"McDonald, F",1,0,0,0,1
"McIntyre, H",0,0,1,0,1
"McLay, B",0,0,0,1,1
"McLemore, M",0,0,1,0,1
"McMahan, G",0,0,0,1,1
"McMahon, A",0,0,0,1,1
"Meacci, F",0,0,1,0,1
"Mehlum, L",0,1,0,0,1
"Mei, H",0,0,0,1,1
"Meier, A",1,0,0,0,1
"Meinzer, M",0,0,1,0,1
"Melancon, B",0,0,0,1,1
"Mels, G",0,0,0,1,1
"Melvin, R",1,0,0,0,1
"Meng, X",0,0,0,1,1
"Mensch, A",0,0,0,1,1
"Merson, L",0,0,1,0,1
"Messinger, A",0,0,0,1,1
"Miao, S",0,0,1,0,1
"Michael, C",0,0,0,1,1
"Michaelis, L",0,0,0,1,1
"Michel, A",1,0,0,0,1
"Miele, L",0,0,0,1,1
"Miguel Mateos Resinas, V",0,0,0,1,1
"Miller, J",0,1,0,0,1
"Milligan, G",0,0,0,1,1
"Miner, A",0,0,1,0,1
"Minter, F",0,1,0,0,1
"Mizuno, A",0,0,1,0,1
"Mo, H",0,1,0,0,1
"Moal, B",0,0,0,1,1
"Modina, E",0,0,0,1,1
"Moelleken, M",0,0,0,1,1
"Moldwin, Z",0,0,0,1,1
"Montagut, N",0,0,1,0,1
"Montalbano, C",0,0,0,1,1
"Moon, K",0,0,1,0,1
"Moon, M",0,1,0,0,1
"Moonen, J",0,0,0,1,1
"Moore, E",0,0,1,0,1
"Moores, K",1,0,0,0,1
"Moradi, H",0,0,1,0,1
"Moreau, T",0,0,0,1,1
"Moreno Sierra, J",1,0,0,0,1
"Moreno, J",0,0,1,0,1
"Moreno-Martos, D",0,0,1,0,1
"Morgan, H",0,0,1,0,1
"Morgan, M",0,1,0,0,1
"Morizono, H",0,0,0,1,1
"Morrison, J",0,1,0,0,1
"Mortier, P",0,1,0,0,1
"Morton, S",1,0,0,0,1
"Mosa, A",0,0,0,1,1
"Mosseveld, B",1,0,0,0,1
"Mottet, N",0,0,1,0,1
"Mouazer, A",0,0,0,1,1
"Mouchet, A",0,0,0,1,1
"Mower, J",1,0,0,0,1
"Mowery, D",0,0,0,1,1
"Moya, A",1,0,0,0,1
"Mudie, R",0,0,0,1,1
"Mugeni, R",0,0,0,1,1
"Mullin, S",0,1,0,0,1
"Mumtaz, S",0,0,0,1,1
"Murad, D",0,0,0,1,1
"Murali, T",1,0,0,0,1
"Murray, D",0,0,0,1,1
"Murugesan, S",0,0,0,1,1
"Musanabaganwa, C",0,0,0,1,1
"Mustapha, M",1,0,0,0,1
"Muñoz Carrero, A",0,0,0,1,1
"Myers, A",0,0,1,0,1
"Ménager, M",0,0,0,1,1
"Méndez-Boo, L",0,0,0,1,1
"Na, H",0,0,0,1,1
"Naderalvojoud, B",1,0,0,0,1
"Nam, K",0,0,0,1,1
"Namjou, B",0,0,0,1,1
"Narayan, V",0,0,1,0,1
"Natarjan, K",0,0,1,0,1
"Nateghi Haredasht, F",0,0,1,0,1
"Natrajan, K",0,0,1,0,1
"Navarro, A",0,0,0,1,1
"Nelson, J",1,0,0,0,1
"Nemati, S",1,0,0,0,1
"Nennecke, A",0,0,0,1,1
"Neo, J",0,0,0,1,1
"Nesterow, I",0,0,0,1,1
"Nestsiarovich, A",0,0,1,0,1
"Neuberg, D",0,0,0,1,1
"Neumaier, M",0,0,0,1,1
"Ng, A",0,0,0,1,1
"Ng, J",0,0,1,0,1
"Ngiam, K",0,0,0,1,1
"Nguyen, Q",1,0,0,0,1
"Nica, R",0,0,1,0,1
"Nicholson, B",0,0,1,0,1
"Nickels, L",0,0,1,0,1
"Nicklin, S",0,0,0,1,1
"Nieboer, D",0,0,1,0,1
"Nieri, P",0,0,1,0,1
"Nikai, E",0,0,0,1,1
"Nikiforaki, K",0,0,0,1,1
"Nikolaidis, G",0,0,1,0,1
"Nikolopoulos, S",0,0,1,0,1
"Nind, T",0,0,0,1,1
"Nishimwe, A",0,0,0,1,1
"Nkurikiyeyezu, K",0,0,0,1,1
"Noh, S",0,0,0,1,1
"Noll, R",0,0,0,1,1
"Nookala, L",0,0,0,1,1
"Normando, P",0,0,0,1,1
"Northstone, K",0,0,0,1,1
"Noseworthy, P",0,0,0,1,1
"Noshad, M",1,0,0,0,1
"Novelli, N",1,0,0,0,1
"Nsanzimana, S",0,0,0,1,1
"Nwankwo, V",0,0,1,0,1
"Nzabanita, J",0,0,0,1,1
"Nürnberg, S",0,0,0,1,1
"Nüßler, F",0,0,0,1,1
"O'Dea, K",0,0,1,0,1
"O'Donnell, C",0,0,1,0,1
"O'Hanlon, S",0,0,1,0,1
"O'Leary, C",0,0,1,0,1
"Oats, J",0,0,1,0,1
"Obeid, J",0,0,0,1,1
"Ochola, M",0,0,0,1,1
"Oehsen, J",0,0,0,1,1
"Oeltze-Jafra, S",0,0,0,1,1
"Oeste, C",1,0,0,0,1
"Oetzmann, C",0,0,1,0,1
"Oganesyan, A",0,0,1,0,1
"Ogunyemi, O",0,0,0,1,1
"Oh, A",0,0,1,0,1
"Oh, T",0,0,1,0,1
"Ohmann, C",1,0,0,0,1
"Okusi, C",0,0,1,0,1
"Oliveira, V",0,0,0,1,1
"Oliver, M",0,0,0,1,1
"Ollivere, B",0,0,0,1,1
"Omenn, G",0,0,0,1,1
"Oneta, O",0,0,1,0,1
"Ong, R",0,0,0,1,1
"Oniani, D",0,0,0,1,1
"Oomens, J",0,0,0,1,1
"Orlova, A",0,0,0,1,1
"Orlova, N",0,0,0,1,1
"Ormiston-Smith, D",0,0,0,1,1
"Orton, C",0,0,0,1,1
"Osborn, D",0,0,1,0,1
"Ott, A",0,0,0,1,1
"Ouagne, D",0,0,0,1,1
"Overhage, M",1,0,0,0,1
"Owen, R",0,0,0,1,1
"Pablo, R",0,0,0,1,1
"Pacaci, A",0,0,0,1,1
"Pace, W",0,0,0,1,1
"Page, D",1,0,0,0,1
"Pajor, N",0,0,0,1,1
"Paka, V",0,0,0,1,1
"Palanisamy, S",0,0,1,0,1
"Palmer, N",0,0,0,1,1
"Paloots, R",0,0,0,1,1
"Panagi, V",0,0,0,1,1
"Panagiotopoulou, M",1,0,0,0,1
"Pang, E",0,0,1,0,1
"Pappas, G",0,0,0,1,1
"Pardee, R",0,0,0,1,1
"Parimbelli, E",0,1,0,0,1
"Park, E",0,0,1,0,1
"Park, G",1,0,0,0,1
"Parker, C",0,0,0,1,1
"Parmanto, B",0,0,0,1,1
"Parry, J",0,0,1,0,1
"Parsons, M",0,0,0,1,1
"Passey, A",0,0,1,0,1
"Pastor, M",0,1,0,0,1
"Patel, A",0,0,1,0,1
"Patel, M",0,0,0,1,1
"Patel, S",1,0,0,0,1
"Pav, V",0,0,0,1,1
"Payen, A",0,0,0,1,1
"Payne, P",1,0,0,0,1
"Pedrera Jiménez, M",0,0,1,0,1
"Pedrera, M",0,0,0,1,1
"Pedrera-Jiménez, M",0,0,0,1,1
"Pei, Z",0,0,0,1,1
"Pembroke, C",0,0,1,0,1
"Penninx, B",0,0,1,0,1
"Percha, B",0,1,0,0,1
"Perera, S",0,0,0,1,1
"Periyakoil, V",1,0,0,0,1
"Perna, M",0,0,1,0,1
"Perotte, A",0,0,1,0,1
"Peters, F",1,0,0,0,1
"Peviani, A",0,0,0,1,1
"Pham, H",0,1,0,0,1
"Pham, M",1,0,0,0,1
"Phillips Hey, S",0,0,0,1,1
"Phillips, L",0,1,0,0,1
"Picelli, G",1,0,0,0,1
"Pieper, S",0,1,0,0,1
"Pierce, I",0,0,0,1,1
"Pierce, J",0,0,1,0,1
"Pigeot, I",0,0,0,1,1
"Pinedo-Villanueva, R",0,0,1,0,1
"Pinheiro, S",1,0,0,0,1
"Pinnau, M",0,1,0,0,1
"Pipaliya, R",0,1,0,0,1
"Pires, F",0,0,0,1,1
"Pittman, T",0,1,0,0,1
"Plaikner, S",0,0,0,1,1
"Planat, V",0,0,0,1,1
"Pliatsika, J",0,0,1,0,1
"Plovnick, R",0,0,0,1,1
"Polce, F",0,1,0,0,1
"Polony, V",0,1,0,0,1
"Popham, D",0,0,0,1,1
"Porsbjerg, C",0,0,0,1,1
"Porterfield, J",0,0,1,0,1
"Portillo-Van Diest, A",0,1,0,0,1
"Power, L",0,0,0,1,1
"Prantl, S",0,1,0,0,1
"Prasser, F",0,1,0,0,1
"Price, B",0,0,1,0,1
"Price, M",0,0,0,1,1
"Prieto Alhambra, D",0,1,0,0,1
"Prinz, M",0,0,0,1,1
"Prior, F",0,1,0,0,1
"Prodan, B",0,0,0,1,1
"Profili, F",0,0,1,0,1
"Przysucha, M",0,0,0,1,1
"Psaty, B",1,0,0,0,1
"Pulgarin, C",0,0,0,1,1
"Pérez-Sola, V",0,1,0,0,1
"Pölzl, G",0,1,0,0,1
"Qian, J",0,0,1,0,1
"Qin, P",0,1,0,0,1
"Quach, J",0,0,0,1,1
"Quaranta, M",0,0,0,1,1
"Quinlan, P",0,0,0,1,1
"Quinnies, K",0,0,1,0,1
"Quiroz, J",0,0,0,1,1
"Raffaele Resta, G",0,0,1,0,1
"Rai, T",0,0,1,0,1
"Raisaro, J",0,0,0,1,1
"Raja, K",0,0,0,1,1
"Ramachandran, K",1,0,0,0,1
"Rambla, J",0,0,0,1,1
"Ramcharran, D",1,0,0,0,1
"Ramirez, A",0,0,1,0,1
"Rana, M",0,0,0,1,1
"Ranallo, P",0,0,0,1,1
"Rance, B",0,0,0,1,1
"Randhawa, G",0,0,1,0,1
"Ranzani, O",0,0,1,0,1
"Rao, P",0,0,0,1,1
"Rao, W",0,0,1,0,1
"Rappoport, N",0,1,0,0,1
"Rath, N",1,0,0,0,1
"Rathod-Mistry, T",0,0,1,0,1
"Ratwani, S",0,0,0,1,1
"Raumann, B",0,1,0,0,1
"Rausch, K",1,0,0,0,1
"Reckard, A",0,0,1,0,1
"Reel, P",0,0,0,1,1
"Reel, S",0,0,0,1,1
"Reeve, M",1,0,0,0,1
"Regge, D",0,0,0,1,1
"Reilly, G",0,0,0,1,1
"Reiter, K",0,0,0,1,1
"Rekkas, A",1,0,0,0,1
"Ren, L",0,0,1,0,1
"Ren, Y",1,0,0,0,1
"Rentko, V",0,0,0,1,1
"Renz, H",0,0,0,1,1
"Resnic, F",0,0,0,1,1
"Reyes Nieva, H",0,0,0,1,1
"Reynolds, C",0,0,0,1,1
"Rhee, Y",1,0,0,0,1
"Rho, M",0,1,0,0,1
"Richter, L",0,0,0,1,1
"Ricket, I",0,1,0,0,1
"Rieux-Laucat, F",0,0,0,1,1
"Rijneek, P",0,0,1,0,1
"Rinaldi, E",0,0,0,1,1
"Rising, S",0,0,0,1,1
"Ritchie, A",0,0,0,1,1
"Rivera, M",1,0,0,0,1
"Robbins, S",0,0,0,1,1
"Robinson, D",0,0,1,0,1
"Robinson, M",0,0,1,0,1
"Robison, B",0,0,0,1,1
"Roboz, G",0,0,0,1,1
"Rocca, M",0,0,0,1,1
"Roderer, N",0,0,0,1,1
"Rodrigues-Jr, J",0,0,0,1,1
"Rohde, C",1,0,0,0,1
"Roig, A",0,0,1,0,1
"Roldán, J",0,0,1,0,1
"Romanelli, P",0,0,1,0,1
"Romano, J",1,0,0,0,1
"Romio, S",1,0,0,0,1
"Rose, M",0,0,1,0,1
"Rosenberg, D",0,0,1,0,1
"Rosenbloom, S",0,0,0,1,1
"Rosenman, M",1,0,0,0,1
"Rosenthal, E",0,0,0,1,1
"Roshdi, M",0,0,0,1,1
"Rothe, U",0,0,1,0,1
"Rothkötter, H",0,0,0,1,1
"Roumie, C",0,0,1,0,1
"Ruber, G",0,0,0,1,1
"Rubio, P",0,0,0,1,1
"Rudisill, P",0,0,0,1,1
"Rudsill, P",0,0,0,1,1
"Rujano, M",1,0,0,0,1
"Runion, T",0,0,1,0,1
"Ruranga, C",0,0,0,1,1
"Russell, B",0,0,1,0,1
"Rutenberg, E",0,1,0,0,1
"Ryang, S",0,0,1,0,1
"Sa, Z",0,0,0,1,1
"Sacchi, L",0,1,0,0,1
"Sadovy, B",0,0,0,1,1
"Sadowski, K",0,1,0,0,1
"Sadsad, R",0,0,0,1,1
"Sahner, D",1,0,0,0,1
"Sakalis, V",0,0,1,0,1
"Sakilay, S",0,1,0,0,1
"Salamanca, E",0,0,0,1,1
"Salles, T",0,0,0,1,1
"Salmasian, H",0,0,1,0,1
"Samans, B",0,1,0,0,1
"Samwald, M",0,0,1,0,1
"Sanavia, T",0,0,0,1,1
"Sandrin, A",0,0,0,1,1
"Santangelo, S",0,0,1,0,1
"Santos, C",0,0,0,1,1
"Santos, R",0,0,0,1,1
"Sanz, F",0,1,0,0,1
"Saptono, A",0,0,0,1,1
"Sarachan, B",0,1,0,0,1
"Saripalle, R",0,0,0,1,1
"Sarkar, I",0,0,0,1,1
"Sarker, S",0,0,0,1,1
"Sattar, N",0,0,0,1,1
"Saunders, G",0,0,0,1,1
"Savova, G",0,1,0,0,1
"Sazo, N",0,0,0,1,1
"Scarnecchia, T",1,0,0,0,1
"Schaaf, J",0,0,0,1,1
"Schade, R",0,0,1,0,1
"Schade-Brittinger, C",0,0,0,1,1
"Schaffhauser, B",1,0,0,0,1
"Scheuemie, M",1,0,0,0,1
"Schiffer-Kane, K",0,0,0,1,1
"Schito, M",0,0,1,0,1
"Schiver, E",0,0,0,1,1
"Schlueter, D",0,1,0,0,1
"Schlüter, A",0,0,0,1,1
"Schmidt, T",0,0,0,1,1
"Schmücker, P",0,0,0,1,1
"Schneeweiss, S",1,0,0,0,1
"Schram, M",0,0,0,1,1
"Schuler, C",0,0,0,1,1
"Schultz, B",0,0,0,1,1
"Schulz, N",1,0,0,0,1
"Schwachhofer, T",0,1,0,0,1
"Schwalm, M",1,0,0,0,1
"Schwarz, P",0,0,0,1,1
"Schöberl, A",0,0,0,1,1
"Schönfeld, N",0,0,0,1,1
"Schüttler, C",0,1,0,0,1
"Scobbie, D",0,0,0,1,1
"Scorsetti, M",0,0,1,0,1
"Scotti, V",0,0,1,0,1
"Scudeller, L",0,0,0,1,1
"Sebire, N",0,0,0,1,1
"Secora, A",0,0,1,0,1
"Sedki, K",0,0,0,1,1
"Sedlmayr, B",0,1,0,0,1
"Seim, A",0,0,0,1,1
"Seinen, T",1,0,0,0,1
"Semakula, M",0,0,0,1,1
"Semple, M",0,0,0,1,1
"Seo, J",0,0,0,1,1
"Seo, Y",0,0,1,0,1
"Seok, J",0,0,0,1,1
"Seong, J",0,0,0,1,1
"Seong, Y",0,0,0,1,1
"Serrano Balazote, P",0,0,1,0,1
"Serrano, P",0,0,0,1,1
"Serrano-Balazote, P",0,0,0,1,1
"Serret-Larmande, A",0,0,0,1,1
"Serve, H",0,0,0,1,1
"Sevareid-Groth, T",0,0,0,1,1
"Sexton, K",0,1,0,0,1
"Seymour, D",0,0,0,1,1
"Sfakianakis, S",0,0,0,1,1
"Shah, R",0,1,0,0,1
"Shah, S",0,0,1,0,1
"Shallcross, L",0,0,0,1,1
"Shan, T",0,0,1,0,1
"Shang, Y",0,1,0,0,1
"Shao, Y",0,0,0,1,1
"Sharma, H",0,0,0,1,1
"Sharma, R",0,0,1,0,1
"Shashikumar, S",1,0,0,0,1
"Shaw, J",0,0,1,0,1
"Shen, F",0,1,0,0,1
"Shen, Y",0,0,1,0,1
"Sherlock, J",0,0,1,0,1
"Shi, J",0,0,0,1,1
"Shi, W",0,0,0,1,1
"Shields, A",0,0,0,1,1
"Shih, G",0,1,0,0,1
"Shih, Y",1,0,0,0,1
"Shin, J",0,0,0,1,1
"Shin, Y",0,0,1,0,1
"Shoemark, A",0,0,0,1,1
"Sibert, N",0,0,0,1,1
"Siddi, S",0,0,1,0,1
"Siebel, J",0,0,0,1,1
"Siew, E",0,0,1,0,1
"Silva, J",0,0,0,1,1
"Simblett, S",0,0,1,0,1
"Simmerling, M",0,0,1,0,1
"Simon, K",0,0,1,0,1
"Simon, S",1,0,0,0,1
"Sims, J",0,0,0,1,1
"Sin, M",0,0,0,1,1
"Sinaci, A",0,0,0,1,1
"Sinclair, J",0,0,0,1,1
"Singh, A",0,0,1,0,1
"Sippl, P",0,1,0,0,1
"Skeldon, S",0,0,1,0,1
"Skidmore, E",0,0,0,1,1
"Slamanig, G",0,1,0,0,1
"Slattery, J",0,0,0,1,1
"Slaymaker, E",0,0,0,1,1
"Sliz, P",0,0,0,1,1
"Sloan-Murphy, D",0,0,0,1,1
"Smith, G",0,0,1,0,1
"Smith, L",1,0,0,0,1
"Smith, P",0,0,0,1,1
"Soby, S",0,0,0,1,1
"Soerjomataram, I",0,0,1,0,1
"Soff, J",0,0,0,1,1
"Solbrig, H",0,0,0,1,1
"Soledad Cepeda, M",0,0,0,1,1
"Solomonides, A",1,0,0,0,1
"Solovyev, P",0,0,0,1,1
"Son, D",0,0,0,1,1
"Sonawane, K",1,0,0,0,1
"Song, E",0,0,0,1,1
"Song, M",0,0,0,1,1
"Song, X",0,1,0,0,1
"Sont, J",0,0,0,1,1
"Sontag, D",0,1,0,0,1
"Sorlí Redó, L",0,0,1,0,1
"Soung, Y",0,0,1,0,1
"South, A",0,0,0,1,1
"South, B",0,0,0,1,1
"Southard, C",0,1,0,0,1
"Southwell, B",0,0,0,1,1
"Spalding, J",0,0,0,1,1
"Spital, C",0,1,0,0,1
"Spotniz, M",0,0,1,0,1
"Springer, C",0,0,1,0,1
"Springstubbe, S",0,0,0,1,1
"Sproviero, W",0,0,1,0,1
"Staab, J",0,0,0,1,1
"Steele, D",0,0,0,1,1
"Stefanski, A",0,0,0,1,1
"Steinmeyer, J",0,0,0,1,1
"Stephens, K",0,1,0,0,1
"Stipancic, A",0,0,0,1,1
"Stone, D",0,0,0,1,1
"Straatman, H",1,0,0,0,1
"Strantz, C",0,1,0,0,1
"Strauss, V",0,0,1,0,1
"Street, W",1,0,0,0,1
"Stuppia, M",0,1,0,0,1
"Stürzl, M",0,1,0,0,1
"Subramanian, D",1,0,0,0,1
"Suh, H",0,0,1,0,1
"Sulieman, L",0,0,1,0,1
"Sullivan, C",0,0,0,1,1
"Sun, J",0,1,0,0,1
"Sung, L",0,0,0,1,1
"Sung, M",1,0,0,0,1
"Sunwoo, L",0,0,0,1,1
"Surampalli, S",0,0,0,1,1
"Sutherland, J",0,0,0,1,1
"Suver, C",0,0,0,1,1
"Suzuki, A",0,0,1,0,1
"Syed, M",0,1,0,0,1
"Syed, S",0,1,0,0,1
"Syeda, H",0,1,0,0,1
"Szarfman, A",0,0,0,1,1
"Szczepanski, P",0,0,0,1,1
"Sánchez-Pla, A",1,0,0,0,1
"Särg, D",0,0,0,1,1
"Tabuenca, J",1,0,0,0,1
"Tachos, N",0,0,0,1,1
"Tahseen, D",0,0,0,1,1
"Tai, E",0,0,0,1,1
"Talvik, H",0,0,0,1,1
"Tamm, S",0,0,0,1,1
"Tammesoo, M",0,0,0,1,1
"Tan, A",0,0,0,1,1
"Tan, D",0,0,0,1,1
"Tan, H",0,0,0,1,1
"Taneja, S",0,0,0,1,1
"Tang, M",0,0,0,1,1
"Tang, Y",0,1,0,0,1
"Tannier, X",0,0,0,1,1
"Tao, C",0,0,0,1,1
"Taraborrelli, M",0,0,1,0,1
"Tarczy-Hornoch, P",0,1,0,0,1
"Tarr, S",0,0,0,1,1
"Tate, S",0,0,1,0,1
"Tavakoli, K",0,0,0,1,1
"Taylor, D",0,1,0,0,1
"Tchetgen Tchetgen, E",1,0,0,0,1
"Teeter, B",1,0,0,0,1
"Ten Brinke, A",0,0,0,1,1
"Tenenbaum, J",0,0,0,1,1
"Teo, D",0,0,0,1,1
"Teviotdale, R",0,0,0,1,1
"Theodoratou, E",0,0,0,1,1
"Theron, E",0,0,0,1,1
"Thomas, M",0,0,1,0,1
"Thomas, N",0,0,1,0,1
"Thomas, S",0,0,1,0,1
"Thompson, A",0,0,0,1,1
"Thoral, P",0,1,0,0,1
"Tibollo, V",0,0,0,1,1
"Tignanelli, C",0,0,0,1,1
"Toddenroth, D",0,1,0,0,1
"Togher, L",0,0,1,0,1
"Toh, S",1,0,0,0,1
"Tomasini, D",0,0,1,0,1
"Torabi, F",0,0,0,1,1
"Touré, V",0,0,0,1,1
"Toy, B",0,0,1,0,1
"Traina, A",0,0,0,1,1
"Trama, A",0,0,1,0,1
"Tramma, L",0,0,0,1,1
"Tramontan, L",0,0,0,1,1
"Tran, T",0,1,0,0,1
"Tran-Nguyen, T",1,0,0,0,1
"Triggiani, L",0,0,1,0,1
"Trinkley, K",0,0,0,1,1
"Tripathy, M",0,0,1,0,1
"Trucco, E",0,0,0,1,1
"Trübe, L",0,0,0,1,1
"Tsang, R",0,0,0,1,1
"Tsapepas, D",0,0,0,1,1
"Tsiknakis, M",0,0,0,1,1
"Tsopra, R",0,0,0,1,1
"Tsou, C",1,0,0,0,1
"Tucker, E",0,0,0,1,1
"Turkmen, C",0,0,1,0,1
"Twizere, C",0,0,0,1,1
"Törnroos, J",0,0,0,1,1
"Uhrich, C",0,0,0,1,1
"Umbel, K",0,0,0,1,1
"Unberath, P",0,0,0,1,1
"Uribe, S",0,0,0,1,1
"Urwin, E",0,0,0,1,1
"Utidjian, L",0,1,0,0,1
"Utumatwishima, J",0,0,0,1,1
"Uusküla, A",0,0,1,0,1
"Uwimana, A",0,0,0,1,1
"Uwineza, A",0,0,0,1,1
"V Patterson, O",0,0,0,1,1
"Vacchi, E",0,0,0,1,1
"Valdes, A",0,0,0,1,1
"Valentine, S",1,0,0,0,1
"Vallet, B",0,0,0,1,1
"Van Der Vegt, A",0,0,0,1,1
"Van Der Zwan, E",0,0,0,1,1
"Van Winzum, A",0,0,0,1,1
"Van den Bergh, R",0,0,1,0,1
"Vance, L",0,0,1,0,1
"Vandenberghe, F",0,0,1,0,1
"Vanderheyden, M",1,0,0,0,1
"Vangala, U",0,0,0,1,1
"Vanguri, R",0,0,1,0,1
"Varley, T",0,0,0,1,1
"Varma, S",0,0,0,1,1
"Varoquaux, G",0,0,0,1,1
"Varrassi, G",0,0,1,0,1
"Vasallo, C",0,0,0,1,1
"Vasilevsky, N",0,0,0,1,1
"Vatani, H",0,0,0,1,1
"Vaterkowski, M",0,0,0,1,1
"Veal, C",0,0,0,1,1
"Velez, M",0,1,0,0,1
"Vengadeswaran, A",0,0,0,1,1
"Verstreken, S",1,0,0,0,1
"Vest, M",0,0,1,0,1
"Vettese, E",0,0,0,1,1
"Victor, W",0,0,1,0,1
"Vie, J",0,0,0,1,1
"Vilagut, G",0,1,0,0,1
"Visani, L",0,0,1,0,1
"Visca, M",0,0,1,0,1
"Vivekanantham, A",0,0,1,0,1
"Vojinovic, D",0,0,0,1,1
"Vora, P",0,0,1,0,1
"Vorisek, C",0,0,0,1,1
"Vormstein, P",0,0,0,1,1
"Wadwa, P",0,0,1,0,1
"Wadwa, R",0,0,1,0,1
"Wagener, H",1,0,0,0,1
"Wagers, S",0,0,0,1,1
"Wagholikar, K",0,1,0,0,1
"Wagner, H",0,0,0,1,1
"Wagner, K",0,0,1,0,1
"Walker, A",1,0,0,0,1
"Walker, M",0,0,0,1,1
"Wallace, R",0,0,0,1,1
"Wallace, S",0,0,0,1,1
"Walters, S",0,0,0,1,1
"Wan, E",0,0,1,0,1
"Wang, M",0,0,0,1,1
"Wang, N",0,0,0,1,1
"Wang, Q",1,0,0,0,1
"Ward, H",0,0,0,1,1
"Wardi, G",1,0,0,0,1
"Wassermann, D",0,0,0,1,1
"Weber, G",0,0,0,1,1
"Weber, I",0,0,1,0,1
"Weeks, J",0,0,0,1,1
"Wegner, P",0,0,0,1,1
"Wei, Y",1,0,0,0,1
"Weibel, D",1,0,0,0,1
"Weinstein, R",0,0,1,0,1
"Weiss, A",1,0,0,0,1
"Wen, C",0,1,0,0,1
"Wendl, C",0,0,0,1,1
"Wentworth, C",0,0,0,1,1
"Westhoff, C",0,0,1,0,1
"Westlund, E",0,0,1,0,1
"Westrich, K",1,0,0,0,1
"Wetherill, G",0,0,0,1,1
"Whitaker, M",0,0,0,1,1
"Whitbread, C",0,0,1,0,1
"White, K",0,0,1,0,1
"White, R",1,0,0,0,1
"Wicks, M",0,0,1,0,1
"Widschwendter, M",0,0,0,1,1
"Wiederhold, A",1,0,0,0,1
"Wiesmüller, F",0,1,0,0,1
"Wilcox, C",0,0,1,0,1
"Wilde, M",0,0,1,0,1
"Wiley, L",0,0,0,1,1
"Wilhelm, M",0,0,0,1,1
"Wilkins, K",1,0,0,0,1
"Williams, D",0,0,0,1,1
"Williams, N",0,0,0,1,1
"Wilson, J",0,1,0,0,1
"Wilson, O",0,0,1,0,1
"Wing, Y",0,0,1,0,1
"Wirth, F",0,1,0,0,1
"Wolf, N",0,1,0,0,1
"Wolters, F",0,0,0,1,1
"Wong, R",1,0,0,0,1
"Wood, I",0,0,1,0,1
"Wood, W",0,0,0,1,1
"Woodcock, J",1,0,0,0,1
"Woong Park, R",0,0,1,0,1
"Worthey, E",1,0,0,0,1
"Wu, H",0,0,0,1,1
"Wu, P",0,0,0,1,1
"Wu, Q",1,0,0,0,1
"Wulff, R",0,0,0,1,1
"Wykes, T",0,0,1,0,1
"Wyrwa, J",0,0,0,1,1
"Xiao, G",0,0,0,1,1
"Xiao, X",1,0,0,0,1
"Xie, Y",0,0,0,1,1
"Xing, F",0,0,1,0,1
"Xu, C",1,0,0,0,1
"Xu, J",0,1,0,0,1
"Yahi, A",0,0,1,0,1
"Yamashita, T",0,0,0,1,1
"Yang, D",0,0,1,0,1
"Yang, H",0,0,0,1,1
"Yang, P",0,0,0,1,1
"Yanover, C",1,0,0,0,1
"Ye, Y",0,1,0,0,1
"Yeow, J",0,0,1,0,1
"Yi, K",0,0,1,0,1
"Yi, W",0,0,1,0,1
"Yi, Y",0,0,1,0,1
"Yin Hui Lai, L",0,0,1,0,1
"Yin, Y",0,0,1,0,1
"Yoo, H",0,0,0,1,1
"Yoon, K",0,0,0,1,1
"Yu, H",0,0,1,0,1
"Yu, L",1,0,0,0,1
"Yu, T",1,0,0,0,1
"Yuen-Chun Teoh, J",1,0,0,0,1
"Yuksel, M",0,0,0,1,1
"Yum, Y",0,0,0,1,1
"Yun, J",0,0,0,1,1
"Zachariadou, M",0,0,1,0,1
"Zahner, J",0,0,0,1,1
"Zai, A",0,0,0,1,1
"Zambelli, A",0,0,0,1,1
"Zambon, M",0,0,1,0,1
"Zanetti, I",0,0,1,0,1
"Zeger, S",0,0,1,0,1
"Zelnis, J",0,1,0,0,1
"Zeng, P",1,0,0,0,1
"Zhang, B",0,0,0,1,1
"Zhang, G",0,1,0,0,1
"Zhang, N",0,0,0,1,1
"Zhang, P",0,1,0,0,1
"Zhao, B",0,0,0,1,1
"Zhao, J",0,0,0,1,1
"Zhen, W",0,0,1,0,1
"Zhong, Y",0,0,0,1,1
"Zhou, L",1,0,0,0,1
"Zhu, D",0,0,1,0,1
"Zhu, V",0,0,0,1,1
"Ziegl, A",0,0,0,1,1
"Zierk, J",0,1,0,0,1
"Zimmet, P",0,0,1,0,1
"Zisser, M",1,0,0,0,1
"Zong, J",1,0,0,0,1
"Zormpas, S",0,0,1,0,1
"Zorych, I",1,0,0,0,1
"Zou, Y",1,0,0,0,1
"Zounemat Kermani, N",0,0,1,0,1
"Zrounba, P",0,0,1,0,1
"Zöller, D",0,1,0,0,1
"de Sousa, F",0,0,0,1,1
"de Veer, B",0,1,0,0,1
"den Otter, S",0,1,0,0,1
"van Baalen, V",0,0,1,0,1
"van Beek, E",0,0,0,1,1
"van Dokkum, P",0,0,1,0,1
"van Klaveren, D",1,0,0,0,1
"van Nuland, R",1,0,0,0,1
"van Wijngaarden, R",0,0,0,1,1
"van der Landen, S",0,0,0,1,1
"von Ziegenweidt, J",0,0,0,1,1
"Álvarez, E",1,0,0,0,1
"Österle, S",0,0,0,1,1
"Østby, J",0,0,0,1,1
"Ückert, F",0,0,0,1,1
"Üresin, A",0,0,1,0,1
"Şen, S",0,0,1,0,1
"Šuvalov, H",0,0,0,1,1
