author,Methodological research,Open source development,Clinical evidence generation,Open community data standards,paperCount
"Ryan, P",89,8,66,24,187
"Schuemie, M",64,8,37,10,119
"Hripcsak, G",45,3,49,9,106
"Prieto-Alhambra, D",12,1,67,5,85
"Rijnbeek, P",31,9,34,8,82
"Suchard, M",36,5,37,0,78
"Park, R",10,4,38,16,68
"Reich, C",12,1,34,17,64
"You, S",7,2,33,15,57
"Kim, J",6,1,34,14,55
"Duarte-Salles, T",9,3,37,2,51
"Shah, N",13,3,21,7,44
"Reps, J",26,5,10,1,42
"Madigan, D",30,1,9,1,41
"Ostropolets, A",12,1,24,4,41
"Falconer, T",10,1,23,1,35
"Burn, E",2,1,26,5,34
"Kim, S",3,0,22,9,34
"Weng, C",13,4,5,11,33
"Kostka, K",6,0,23,2,31
"Lee, S",2,1,22,6,31
"Sedlmayr, M",2,4,0,25,31
"Matheny, M",3,1,22,4,30
"Prats-Uribe, A",4,0,26,0,30
"Blacketer, C",2,2,18,6,28
"DuVall, S",4,0,20,4,28
"Morales, D",3,0,22,1,26
"Pratt, N",7,1,15,3,26
"Sena, A",3,3,20,0,26
"Chen, Y",13,1,9,2,25
"Kim, Y",2,0,19,3,24
"Park, J",1,2,18,3,24
"Alshammari, T",5,0,17,1,23
"Yoo, S",4,0,12,7,23
"Defalco, F",4,3,12,3,22
"Delmestri, A",0,0,22,0,22
"Golozar, A",4,0,17,1,22
"Stang, P",9,1,8,4,22
"Tatonetti, N",8,2,7,5,22
"Williams, A",7,0,7,8,22
"Williams, R",14,2,5,1,22
"Kim, C",6,1,11,3,21
"Kim, K",1,0,17,3,21
"Lee, D",0,0,17,4,21
"Swerdel, J",9,3,9,0,21
"Banda, J",5,2,7,6,20
"Natarajan, K",3,0,9,8,20
"Nyberg, F",6,0,14,0,20
"Voss, E",5,1,7,7,20
"Kahn, M",1,0,5,13,19
"Lu, Y",5,0,12,2,19
"Lynch, K",3,0,14,2,19
"Minty, E",7,0,11,1,19
"Verhamme, K",5,2,12,0,19
"Fernandez-Bertolin, S",3,1,12,2,18
"Kors, J",12,1,5,0,18
"Li, X",7,1,8,2,18
"Spotnitz, M",4,0,10,3,17
"Zhang, L",5,0,12,0,17
"Areia, C",4,0,12,0,16
"Bathelt, F",1,2,0,13,16
"Henke, E",1,1,0,14,16
"Lai, L",6,0,10,0,16
"Park, S",0,0,11,5,16
"Peng, Y",0,2,1,13,16
"Posada, J",1,1,14,0,16
"Rao, G",6,2,8,0,16
"Reinecke, I",2,4,0,10,16
"Shoaibi, A",4,1,11,0,16
"Weaver, J",3,1,12,0,16
"Xu, H",5,3,4,4,16
"Schilling, L",0,0,11,4,15
"Seager, S",1,0,13,1,15
"Zoch, M",1,2,0,12,15
"Catala, M",0,1,12,1,14
"Huser, V",1,2,5,6,14
"Kolde, R",2,2,7,3,14
"Krumholz, H",1,0,13,0,14
"Lee, H",1,0,10,3,14
"Lee, J",2,1,9,2,14
"Lee, K",0,0,13,1,14
"Lee, Y",1,0,8,5,14
"Makadia, R",2,2,8,2,14
"Alghoul, H",1,0,12,0,13
"Alser, O",0,0,13,0,13
"Boland, M",4,0,5,4,13
"Chen, J",2,1,8,2,13
"Duke, J",2,3,5,3,13
"Jiang, G",1,2,0,10,13
"Khalid, S",2,1,9,1,13
"Kim, H",0,0,10,3,13
"Li, J",2,1,6,4,13
"Liu, H",5,3,1,4,13
"Man, K",1,0,10,2,13
"Mayer, M",3,2,7,1,13
"Pistillo, A",0,0,12,1,13
"Ramírez-Anguita, J",3,2,7,1,13
"Reyes, C",0,0,12,1,13
"Berlin, J",6,0,6,0,12
"Casajust, P",3,0,9,0,12
"Chen, R",2,0,8,2,12
"John, L",6,0,6,0,12
"Lane, J",1,0,11,0,12
"Xie, J",0,0,11,1,12
"Bu, F",3,0,8,0,11
"Cho, J",0,1,7,3,11
"Dawoud, D",1,1,8,1,11
"Fortin, S",4,1,5,1,11
"Fridgeirsson, E",8,1,2,0,11
"Hardin, J",3,2,6,0,11
"Nagy, P",1,0,7,3,11
"Nishimura, A",2,0,9,0,11
"Tong, J",8,0,3,0,11
"Zhang, Y",1,1,7,2,11
"Aragon, M",2,0,7,1,10
"Choi, J",2,0,5,3,10
"Choi, S",0,0,6,4,10
"Chute, C",3,0,3,4,10
"Conover, M",4,1,5,0,10
"Hartzema, A",7,0,0,3,10
"Jonnagaddala, J",3,0,5,2,10
"Li, L",3,1,6,0,10
"Meeker, D",0,1,2,7,10
"Park, C",0,0,7,3,10
"Recalde, M",0,0,9,1,10
"Roel, E",0,0,9,1,10
"Seo, S",2,0,8,0,10
"Ta, C",4,1,3,2,10
"Tan, E",1,0,9,0,10
"Van Zandt, M",3,0,6,1,10
"Vizcaya, D",1,1,8,0,10
"Zhang, X",1,0,6,3,10
"Ahmed, W",0,0,9,0,9
"Baek, H",2,0,3,4,9
"Callahan, T",1,0,1,7,9
"Cho, S",1,0,2,6,9
"Forrest, C",3,0,5,1,9
"Haendel, M",3,0,3,3,9
"Jödicke, A",1,0,7,1,9
"Markus, A",6,1,2,0,9
"Park, Y",1,1,5,2,9
"Pfaff, E",2,0,3,4,9
"Prokosch, H",0,4,0,5,9
"Wang, L",1,1,6,1,9
"Wong, I",1,1,5,2,9
"Yin, C",0,0,9,0,9
"Zhang, B",2,0,6,1,9
"Zhou, T",1,1,7,0,9
"van der Lei, J",5,1,2,1,9
"Bian, J",5,0,2,1,8
"Butler, A",5,1,1,1,8
"Cha, J",0,0,7,1,8
"Choi, B",2,0,4,2,8
"Fife, D",4,0,3,1,8
"Gong, M",0,0,8,0,8
"Kim, B",0,0,7,1,8
"Lambert, C",1,0,6,1,8
"Lamer, A",0,2,0,6,8
"Liaw, S",3,0,1,4,8
"Liu, C",2,0,3,3,8
"Oja, M",1,1,3,3,8
"Overhage, J",5,0,0,3,8
"Park, K",0,0,6,2,8
"Shang, N",3,2,0,3,8
"Viernes, B",1,0,5,2,8
"Wang, Y",1,1,3,3,8
"Yu, Y",1,0,0,7,8
"Arshad, F",4,0,3,0,7
"Brown, J",0,1,0,6,7
"Denny, J",1,1,1,4,7
"Dorr, D",0,0,5,2,7
"DuMouchel, W",7,0,0,0,7
"Hong, N",1,2,2,2,7
"Hussein, R",0,1,0,6,7
"Hwang, H",0,0,5,2,7
"Jang, J",0,0,6,1,7
"Joo, H",0,0,3,4,7
"Kern, D",2,0,5,0,7
"Khera, R",1,0,6,0,7
"Lau, W",0,0,7,0,7
"Li, Y",1,2,2,2,7
"Man, W",0,0,7,0,7
"Mercadé-Besora, N",1,0,6,0,7
"Moffitt, R",3,0,3,1,7
"Murphy, S",1,1,0,5,7
"Newby, D",0,1,6,0,7
"Rhee, S",1,0,6,0,7
"Seinen, T",6,0,1,0,7
"Shah, K",0,0,7,0,7
"Shin, S",1,0,3,3,7
"Strauss, V",2,0,5,0,7
"Sun, Y",3,2,0,2,7
"Trinh, N",0,0,5,2,7
"Yang, C",6,1,0,0,7
"Yuan, Z",1,0,6,0,7
"Zhang, D",2,0,5,0,7
"Zhou, J",2,0,4,1,7
"van Mulligen, E",4,0,3,0,7
"Ahmadi, N",1,0,0,5,6
"Bate, A",4,0,1,1,6
"Baxter, S",0,0,2,4,6
"Bennett, T",2,0,2,2,6
"Blasini, R",0,5,0,1,6
"Boyce, R",1,1,1,3,6
"Brash, J",1,0,5,0,6
"Burkard, T",0,0,4,2,6
"Carroll, R",0,1,2,3,6
"Cepeda, M",1,0,5,0,6
"Chai, Y",0,0,6,0,6
"Choi, I",0,0,3,3,6
"Cornet, R",0,1,0,5,6
"Davydov, A",0,0,2,4,6
"Denaxas, S",1,0,3,2,6
"Dudley, J",0,1,5,0,6
"Dymshyts, D",0,0,1,5,6
"Horban, S",0,1,4,1,6
"Hughes, N",1,2,2,1,6
"Jeon, H",2,0,2,2,6
"Jhaveri, R",2,0,4,0,6
"Jung, S",0,0,3,3,6
"Katsch, F",0,0,0,6,6
"Lee, E",0,0,6,0,6
"Moinat, M",0,0,1,5,6
"Mosseveld, M",0,0,5,1,6
"Nguyen, P",0,0,4,2,6
"Oh, S",1,0,1,4,6
"Park, H",0,0,3,3,6
"Rasmussen, L",1,2,0,3,6
"Rosen, A",3,0,3,0,6
"Shin, W",0,0,6,0,6
"Sturkenboom, M",3,0,1,2,6
"Subbian, V",0,0,6,0,6
"Uusküla, A",0,0,6,0,6
"Wei, W",1,0,0,5,6
"Wen, A",1,1,0,4,6
"Wolfien, M",1,0,0,5,6
"Wu, Q",2,0,4,0,6
"Zhou, Y",2,1,1,2,6
"Abrahao, M",2,0,3,0,5
"Almeida, J",2,2,0,1,5
"Asch, D",3,0,2,0,5
"Belenkaya, R",1,0,0,4,5
"Bhattacharjee, T",0,0,0,5,5
"Cai, C",0,0,3,2,5
"Callahan, A",2,1,1,1,5
"Chen, Z",2,1,1,1,5
"Christakis, D",1,0,4,0,5
"Chung, Y",0,0,5,0,5
"Coloma, P",4,0,0,1,5
"De Keizer, N",0,1,0,4,5
"Dedman, D",0,0,5,0,5
"Duftschmid, G",0,0,0,5,5
"Gabriel, D",0,0,2,3,5
"Gilbert, J",2,2,1,0,5
"Gini, R",2,0,1,2,5
"Girvin, A",2,0,2,1,5
"Goetz, K",0,0,3,2,5
"Greenfield, J",0,0,0,5,5
"Gruhl, M",0,1,0,4,5
"Guo, Y",1,2,2,0,5
"Gögenur, I",3,0,2,0,5
"Hester, L",0,0,5,0,5
"Hong, S",1,0,2,2,5
"Hribar, M",0,0,3,2,5
"Kaas-Hansen, B",2,0,3,0,5
"Kim, D",1,0,3,1,5
"Kim, M",0,0,5,0,5
"Knoll, C",2,2,0,1,5
"Ko, S",0,0,3,2,5
"Liang, C",4,0,1,0,5
"López-Güell, K",0,1,3,1,5
"Martinez, A",1,0,2,2,5
"McMurry, J",1,0,3,1,5
"Mehta, P",0,0,5,0,5
"Mosa, A",0,0,4,1,5
"Natsiavas, P",0,0,3,2,5
"Nordeng, H",0,0,4,1,5
"Oliveira, J",1,2,0,2,5
"Ong, T",0,0,3,2,5
"Pacheco, J",1,2,0,2,5
"Papez, V",1,0,2,2,5
"Park, D",1,1,1,2,5
"Park, M",1,0,2,2,5
"Pera, V",3,0,2,0,5
"Popoff, B",0,2,0,3,5
"Prats, C",0,0,5,0,5
"Reisberg, S",1,2,0,2,5
"Rekkas, A",3,0,1,1,5
"Ryu, B",2,0,1,2,5
"Simon, K",2,0,3,0,5
"Son, S",0,0,5,0,5
"Todd, J",0,0,0,5,5
"Torre, C",1,0,4,0,5
"Trifirò, G",3,0,0,2,5
"Vashisht, R",1,0,4,0,5
"Weinstein, R",3,0,2,0,5
"Weiskopf, N",0,0,2,3,5
"Williams, D",0,0,4,1,5
"Yang, J",1,1,3,0,5
"Yi, S",0,0,2,3,5
"Yoon, J",0,0,4,1,5
"Yu, D",0,0,3,2,5
"Yuan, C",1,2,1,1,5
"Zorych, I",5,0,0,0,5
"Zozus, M",0,1,0,4,5
"de Wilde, M",0,0,5,0,5
"Abrahamsen, B",0,0,4,0,4
"Ahn, S",0,0,4,0,4
"Amadi, D",0,0,0,4,4
"Aminorroaya, A",1,0,3,0,4
"Bailey, L",1,0,1,2,4
"Barclay, N",0,0,3,1,4
"Becich, M",0,1,2,1,4
"Bissell, M",1,0,1,2,4
"Black, A",1,2,0,1,4
"Boo, D",0,0,3,1,4
"Bracons Cucó, G",0,0,0,4,4
"Bradwell, K",1,0,2,1,4
"Brand, M",2,0,1,1,4
"Chan You, S",0,0,4,0,4
"Chang, D",0,0,4,0,4
"Cheong, J",1,0,2,1,4
"Choi, Y",2,0,2,0,4
"Chytas, A",0,0,2,2,4
"Cimino, J",0,0,0,4,4
"Cook, M",0,0,4,0,4
"Desai, P",1,0,3,0,4
"Dhingra, L",1,0,3,0,4
"Evans-Axelsson, S",1,0,3,0,4
"Frid, S",0,0,0,4,4
"Ganslandt, T",0,0,0,4,4
"Giangreco, N",1,2,1,0,4
"Gurley, M",0,0,0,4,4
"Harpaz, R",3,0,0,1,4
"Haug, M",1,1,1,1,4
"He, X",2,0,1,1,4
"He, Y",0,0,3,1,4
"Heider, P",1,2,0,1,4
"Hsu, J",0,0,3,1,4
"Hsu, M",0,0,3,1,4
"Im, Y",0,0,2,2,4
"Jeon, Y",0,0,3,1,4
"Jeong, C",0,0,2,2,4
"Jin, P",1,1,2,0,4
"Jo, S",0,0,3,1,4
"Johnson, S",1,0,0,3,4
"Kang, T",0,2,0,2,4
"Khare, R",0,1,0,3,4
"Kim, T",0,0,3,1,4
"Kiragga, A",0,0,0,4,4
"Kiwuwa-Muyingo, S",0,0,0,4,4
"Klann, J",0,1,0,3,4
"Kolovos, S",0,0,4,0,4
"Krastev, E",0,0,2,2,4
"Lehmann, H",1,0,1,2,4
"Li, K",1,0,3,0,4
"Liu, F",1,0,2,1,4
"Liu, Y",0,0,4,0,4
"Luo, Y",1,2,0,1,4
"Machado, A",1,0,3,0,4
"Maljković, F",1,1,2,0,4
"Manna, A",2,0,1,1,4
"Matcho, A",2,0,0,2,4
"Mathioudakis, N",0,0,4,0,4
"McLeggon, J",2,0,2,0,4
"Meystre, S",1,2,0,1,4
"Moskovitch, R",4,0,0,0,4
"N'Dow, J",1,0,3,0,4
"Norén, G",1,1,1,1,4
"Ochola, M",0,0,0,4,4
"Ohno-Machado, L",1,0,1,2,4
"Palchuk, M",0,0,1,3,4
"Park, B",0,1,3,0,4
"Park, E",0,0,4,0,4
"Park, T",0,0,4,0,4
"Parrot, A",0,1,0,3,4
"Perotte, A",2,0,1,1,4
"Pineda-Moncusí, M",0,0,4,0,4
"Raventós, B",0,1,2,1,4
"Reeves, R",0,1,0,3,4
"Rho, Y",1,0,2,1,4
"Rogers, J",1,0,2,1,4
"Rosenthal, N",0,0,4,0,4
"Ross, J",1,0,2,1,4
"Ruddy, K",1,0,0,3,4
"Setoguchi, S",0,0,2,2,4
"Steinbeisser, C",0,1,3,0,4
"Steyerberg, E",4,0,0,0,4
"Storf, H",1,0,0,3,4
"Taylor, B",1,0,3,0,4
"Tcharaktchiev, D",0,0,2,2,4
"Thangaraj, P",1,2,1,0,4
"Thurin, N",3,0,1,0,4
"Tian, Y",2,1,1,0,4
"Utidjian, L",1,1,1,1,4
"Van Speybroeck, M",0,0,2,2,4
"Vilo, J",0,2,0,2,4
"Walden, A",0,0,2,2,4
"Wang, F",2,2,0,0,4
"Wang, S",1,1,1,1,4
"Warner, J",1,0,0,3,4
"Weidner, J",0,0,0,4,4
"Welebob, E",3,0,0,1,4
"Wilcox, A",0,1,2,1,4
"Wu, Y",1,0,3,0,4
"Yang, K",0,0,4,0,4
"Yanover, C",2,0,2,0,4
"Yoo, J",0,0,4,0,4
"Zhang, S",0,1,1,2,4
"Zhou, X",2,0,0,2,4
"Zong, N",1,0,0,3,4
"de Groot, R",0,1,0,3,4
"Abanos, S",0,0,1,2,3
"Abbott, T",0,0,3,0,3
"Abellan, A",0,0,2,1,3
"Abolina, I",0,0,3,0,3
"Adams, W",0,1,0,2,3
"Ahn, E",1,0,0,2,3
"Albers, D",3,0,0,0,3
"Alloni, A",0,2,0,1,3
"Amor, B",1,0,1,1,3
"Amutha, A",0,0,3,0,3
"Anand, A",2,0,1,0,3
"Anand, T",1,0,2,0,3
"Asiimwe, A",1,0,2,0,3
"Bacci, S",0,0,3,0,3
"Bardenheuer, K",0,0,2,1,3
"Barzdina, E",0,0,3,0,3
"Bauck, A",0,0,0,3,3
"Bellentani, M",0,0,1,2,3
"Benichou, J",3,0,0,0,3
"Benoit, B",1,0,0,2,3
"Bergin, C",0,0,3,0,3
"Beuscart, J",0,0,0,3,3
"Biedermann, P",0,0,2,1,3
"Bjartell, A",1,0,2,0,3
"Blin, P",3,0,0,0,3
"Boeker, M",0,1,0,2,3
"Bouzillé, G",0,1,0,2,3
"Bowring, M",0,0,3,0,3
"Brolin, K",0,0,3,0,3
"Bräuner, K",3,0,0,0,3
"Bunnell, H",1,0,2,0,3
"Butte, A",0,2,1,0,3
"Carter, W",0,0,3,0,3
"Casiraghi, E",1,0,1,1,3
"Choi, H",1,0,2,0,3
"Chrischilles, E",0,0,3,0,3
"Cisneros, M",0,0,3,0,3
"Clusa Cuesta, L",0,0,3,0,3
"Coleman, B",1,0,1,1,3
"Cornford, P",1,0,2,0,3
"Cuccu, Z",0,0,3,0,3
"Cuggia, M",0,1,0,2,3
"Culhane, A",0,0,3,0,3
"D'Agostino, R",0,0,3,0,3
"Dabelea, D",0,0,3,0,3
"Daniel, C",1,0,0,2,3
"De Meulder, B",0,0,3,0,3
"Delange, B",0,2,0,1,3
"Didden, E",0,0,2,1,3
"Drakos, I",2,0,1,0,3
"Droz-Perroteau, C",3,0,0,0,3
"Du, M",1,1,1,0,3
"Duan, R",3,0,0,0,3
"El-Hay, T",2,0,1,0,3
"Elhadad, N",0,1,1,1,3
"Ernst, M",0,0,3,0,3
"Espinoza, J",0,1,0,2,3
"Evans, L",1,1,0,1,3
"Ferguson, L",0,0,3,0,3
"Fleming, C",0,0,3,0,3
"Florescu, S",0,0,3,0,3
"French, T",0,1,2,0,3
"Friedman, C",3,0,0,0,3
"Gabetta, M",0,2,0,1,3
"Gagne, J",3,0,0,0,3
"Gaio, V",0,0,3,0,3
"Gall, W",0,0,0,3,3
"Gandaglia, G",1,0,2,0,3
"Ge, J",1,0,2,0,3
"Gebler, R",0,1,0,2,3
"Glicksberg, B",0,2,1,0,3
"Gravele, D",0,0,3,0,3
"Griffier, R",1,0,1,1,3
"Gruber, S",3,0,0,0,3
"Gulden, C",0,3,0,0,3
"Guo, J",0,0,2,1,3
"Gögenur, M",2,0,1,0,3
"Hajagos, J",1,0,1,1,3
"Halfpenny, W",0,0,0,3,3
"Halvorsen, L",0,0,0,3,3
"Hamman, R",0,0,3,0,3
"Han, M",0,0,3,0,3
"Hanchrow, E",0,0,2,1,3
"Haynes, K",1,0,2,0,3
"Hernandez-Boussard, T",2,0,1,0,3
"Hijazy, A",0,0,3,0,3
"Hockett, C",0,0,3,0,3
"Houghtaling, J",0,1,0,2,3
"Ioannou, S",2,1,0,0,3
"Iqbal, U",0,0,2,1,3
"Isom, S",0,0,3,0,3
"Jefferson, E",0,1,0,2,3
"Jensen, E",0,0,3,0,3
"Jeon, J",0,0,2,1,3
"Jeon, K",0,0,0,3,3
"Jung, C",0,0,3,0,3
"Jung, K",0,0,3,0,3
"Kaduk, D",0,1,1,1,3
"Kallfelz, M",0,0,0,3,3
"Kalokyri, V",1,0,0,2,3
"Kamijima, Y",0,0,2,1,3
"Kang, M",1,0,0,2,3
"Kang, S",1,0,2,0,3
"Kenny, C",0,0,3,0,3
"Kent, S",0,0,2,1,3
"Kerner, B",1,0,2,0,3
"Kiefer, R",0,2,0,1,3
"Kim, E",0,0,3,0,3
"Kimura, S",0,0,2,1,3
"Klazinga, N",0,0,1,2,3
"Kondylakis, H",0,0,0,3,3
"Kosa, A",0,0,3,0,3
"Kreiner, K",0,1,0,2,3
"Krievins, D",0,0,3,0,3
"Kubota, K",0,0,2,1,3
"Kwak, M",0,0,3,0,3
"Kwon, Y",0,0,3,0,3
"Lai, J",1,0,2,0,3
"Lassalle, R",3,0,0,0,3
"Latorre-Millán, M",0,0,3,0,3
"Laur, S",0,1,0,2,3
"Lauschensky, A",0,1,0,2,3
"Lawrence, J",0,0,3,0,3
"Lazar, M",0,0,3,0,3
"Lee, A",0,0,1,2,3
"Lei, Y",0,0,3,0,3
"Leis, A",1,2,0,0,3
"Li, C",1,0,1,1,3
"Lin, X",0,0,3,0,3
"Liu, M",1,1,1,0,3
"Liu, S",1,1,0,1,3
"Lohur, L",0,0,3,0,3
"Lorberbaum, T",2,0,1,0,3
"Luo, C",3,0,0,0,3
"Luo, H",0,0,3,0,3
"Lyu, T",3,0,0,0,3
"Madlock-Brown, C",1,0,0,2,3
"Maier, C",0,1,0,2,3
"Majeed, R",0,1,0,2,3
"Marquardt, K",0,1,0,2,3
"Martin, B",0,0,2,1,3
"Martinez Roldan, J",0,0,3,0,3
"Mateu, L",0,0,3,0,3
"Mayer-Davis, E",0,0,3,0,3
"Mazzaglia, G",2,0,0,1,3
"McGrath, J",0,0,3,0,3
"Michel-Backofen, A",0,1,0,2,3
"Milagro, A",0,0,3,0,3
"Miller, T",0,0,0,3,3
"Mohan, S",0,0,0,3,3
"Mohan, V",0,0,3,0,3
"Molinaro, A",2,1,0,0,3
"Moore, J",2,0,0,1,3
"Moore, N",3,0,0,0,3
"Mooses, K",0,1,0,2,3
"Morris, J",0,0,3,0,3
"Mun, Y",0,0,3,0,3
"Muñoz-Almagro, C",0,0,3,0,3
"Nardone, A",0,0,3,0,3
"Nestor, J",0,0,1,2,3
"Nestsiarovich, A",1,0,2,0,3
"Nicoletti, R",1,0,2,0,3
"Niehaus, E",1,0,0,2,3
"Pace, W",0,0,1,2,3
"Paeng, J",0,0,2,1,3
"Pajor, N",1,0,1,1,3
"Pajusalu, M",1,1,0,1,3
"Paredes, R",0,0,3,0,3
"Paris, N",0,0,0,3,3
"Park, W",0,0,0,3,3
"Parry, R",2,0,1,0,3
"Pathak, J",0,2,0,1,3
"Perkins, D",1,0,2,0,3
"Pfohl, S",2,0,1,0,3
"Phuong, J",0,0,0,3,3
"Polubriaginof, F",1,0,1,1,3
"Popescu, C",0,0,3,0,3
"Praveen, P",0,0,3,0,3
"Puttmann, D",0,1,0,2,3
"Pénichon, M",3,0,0,0,3
"Qureshi, N",1,0,1,1,3
"Racoosin, J",2,0,1,0,3
"Ramcharran, D",2,0,1,0,3
"Rao, S",1,0,2,0,3
"Rassen, J",3,0,0,0,3
"Reese, J",1,0,1,1,3
"Rhee, H",0,0,3,0,3
"Richter, L",0,0,2,1,3
"Rinner, C",0,0,0,3,3
"Rivera, D",0,0,1,2,3
"Robinson, P",1,0,1,1,3
"Roh, J",0,0,0,3,3
"Ryoo, H",0,0,2,1,3
"Santos, R",0,1,0,2,3
"Sanz, F",0,2,0,1,3
"Sarkar, I",0,0,1,2,3
"Sathappan, S",0,0,2,1,3
"Sato, A",0,0,2,1,3
"Sauermann, S",0,1,0,2,3
"Savulescu, C",0,0,3,0,3
"Schaaf, J",1,0,0,2,3
"Schreier, G",0,1,0,2,3
"Schwenk, H",0,0,3,0,3
"Seo, W",0,0,3,0,3
"Sharma, D",0,0,0,3,3
"Shea, S",0,0,3,0,3
"Sheikh, A",0,1,0,2,3
"Shervey, M",0,1,2,0,3
"Sills, M",1,0,2,0,3
"Simpson, S",3,0,0,0,3
"Song, J",0,0,3,0,3
"Song, W",1,0,1,1,3
"Sontag, D",1,1,1,0,3
"Spratt, H",0,0,2,1,3
"Stewart, H",1,0,1,1,3
"Su, C",0,0,2,1,3
"Subirats, P",0,0,3,0,3
"Sui, J",0,0,3,0,3
"Sung, C",0,0,2,1,3
"Tandon, N",0,0,3,0,3
"Tang, H",0,0,3,0,3
"Taylor, A",0,0,0,3,3
"Tietzova, I",0,0,3,0,3
"Toy, B",0,0,2,1,3
"Tsouchnika, A",3,0,0,0,3
"Tsuji, S",1,0,0,2,3
"Van Hemelrijck, M",2,0,1,0,3
"Waitman, L",0,0,0,3,3
"Wan, E",0,0,3,0,3
"Wang, H",1,0,2,0,3
"Wang, X",0,0,2,1,3
"Wang, Z",0,0,3,0,3
"Weill, A",3,0,0,0,3
"Wen, H",0,0,3,0,3
"Willemse, P",1,0,2,0,3
"Wong, J",2,0,1,0,3
"Woo, S",0,0,3,0,3
"Xu, B",0,0,1,2,3
"Xu, Y",1,0,1,1,3
"Yang, S",0,0,3,0,3
"Yoo, I",0,0,2,1,3
"Yoo, Y",2,0,1,0,3
"Yoon, D",1,0,0,2,3
"Yoon, Y",1,0,1,1,3
"Zavadska, D",0,0,3,0,3
"Zhan, S",0,0,0,3,3
"Zhang, G",0,1,2,0,3
"Zhu, H",0,0,3,0,3
"Zhu, R",1,0,1,1,3
"Zvirbulis, V",0,0,3,0,3
"de Lusignan, S",0,0,1,2,3
"de Ridder, M",1,1,0,1,3
"van Bochove, K",0,1,2,0,3
"van Sandijk, S",0,0,1,2,3
"Abeysinghe, R",0,0,0,2,2
"Adekkanattu, P",0,2,0,0,2
"Aizenstein, H",0,0,2,0,2
"Akbari, A",0,0,1,1,2
"Al-Shukri, S",0,1,0,1,2
"Albogami, Y",1,0,1,0,2
"Allakhverdiiev, E",1,0,1,0,2
"Alonso, J",0,2,0,0,2
"Alonso, S",0,0,2,0,2
"Amigo, F",0,2,0,0,2
"Ancker, J",0,2,0,0,2
"Andreescu, C",0,0,2,0,2
"Andryc, A",0,1,1,0,2
"Anzalone, A",0,0,1,1,2
"Arensman, E",0,2,0,0,2
"Argyriou, G",1,0,1,0,2
"Arinze, J",0,0,2,0,2
"Asselbergs, F",0,0,0,2,2
"Averitt, A",2,0,0,0,2
"Avillach, P",0,0,0,2,2
"Avilés-Jurado, F",0,0,2,0,2
"Baghal, A",0,1,0,1,2
"Bahroos, N",0,1,0,1,2
"Bakhshi-Raiez, F",0,0,0,2,2
"Barbarini, N",0,2,0,0,2
"Barboza, C",0,1,1,0,2
"Barletta, V",0,0,1,1,2
"Barnard, J",0,0,0,2,2
"Bartos, M",0,0,0,2,2
"Baumgartner, M",0,1,0,1,2
"Baumgartner, W",1,0,0,1,2
"Baxter, R",0,0,0,2,2
"Beaton, M",0,0,1,1,2
"Beck, J",0,1,0,1,2
"Beggs, J",0,0,0,2,2
"Bell, D",0,0,1,1,2
"Bergquist, T",1,0,1,0,2
"Berman, L",0,0,0,2,2
"Bernarding, J",0,0,0,2,2
"Bertolin, S",0,0,1,1,2
"Beyer, K",1,0,1,0,2
"Beyer, S",0,0,0,2,2
"Bhargav, M",0,2,0,0,2
"Birch, R",0,0,1,1,2
"Bjureberg, J",0,2,0,0,2
"Blaisure, J",0,0,0,2,2
"Blau, H",1,0,1,0,2
"Blecker, S",0,0,2,0,2
"Bonù, M",0,0,2,0,2
"Borghetti, P",0,0,2,0,2
"Bosca, D",0,0,1,1,2
"Boyle, D",0,0,0,2,2
"Bradley, D",0,0,0,2,2
"Brandt, E",0,0,0,2,2
"Brandt, P",0,2,0,0,2
"Breant, S",0,0,0,2,2
"Bremer, C",1,0,1,0,2
"Briganti, A",0,0,2,0,2
"Brooks, I",0,0,1,1,2
"Burrows, E",0,0,0,2,2
"Byford, R",0,0,1,1,2
"Campi, R",0,0,2,0,2
"Campion, T",0,0,0,2,2
"Cappelletti, L",1,0,1,0,2
"Carrell, D",1,0,0,1,2
"Carus, J",1,0,0,1,2
"Castano, V",1,0,1,0,2
"Ceusters, W",0,0,0,2,2
"Chae, S",0,0,2,0,2
"Chakrabarti, S",2,0,0,0,2
"Chan, E",0,0,2,0,2
"Chang, H",1,0,1,0,2
"Chang, T",0,0,1,1,2
"Chattopadhyay, S",0,0,2,0,2
"Chazard, E",0,0,0,2,2
"Chen, A",0,0,1,1,2
"Chen, E",0,0,1,1,2
"Chen, L",0,0,2,0,2
"Chen, W",1,0,0,1,2
"Chen, X",0,0,1,1,2
"Chia-Cheng Lai, E",0,0,2,0,2
"Cho, M",1,0,0,1,2
"Cho, W",0,0,2,0,2
"Choi, W",0,0,0,2,2
"Chui, C",0,0,2,0,2
"Chung, E",0,0,2,0,2
"Chung, W",0,0,1,1,2
"Chuter, A",0,0,0,2,2
"Clark, E",0,0,0,2,2
"Clausen, J",2,0,0,0,2
"Cohet, C",0,0,2,0,2
"Colborn, K",1,0,1,0,2
"Cole, C",0,1,0,1,2
"Collins, G",0,0,2,0,2
"Coma, E",0,0,2,0,2
"Conde, S",0,2,0,0,2
"Cooper, C",0,0,2,0,2
"Corby, G",1,0,1,0,2
"Cowell, L",1,0,1,0,2
"Cox, S",0,1,0,1,2
"Craig, R",0,0,2,0,2
"Craiu, M",0,0,2,0,2
"Cricelli, I",0,0,1,1,2
"Cui, L",0,0,0,2,2
"Dahm, L",0,0,2,0,2
"Dal Co, G",0,0,1,1,2
"Danilovic, A",0,1,1,0,2
"Datta, D",0,2,0,0,2
"Davidson, B",0,0,0,2,2
"Daza, J",0,0,2,0,2
"De Gaetano Donati, K",0,0,2,0,2
"Deer, R",0,0,2,0,2
"Dellavalle, R",0,0,2,0,2
"Delseny, D",0,0,2,0,2
"Denton, J",0,0,1,1,2
"Dernie, F",1,0,1,0,2
"Desai, M",0,0,2,0,2
"Dewey, B",0,0,0,2,2
"Dhruva, S",1,0,0,1,2
"DiPalazzo, J",0,0,1,1,2
"Dikilitas, O",1,0,0,1,2
"Dimitriadis, V",0,0,2,0,2
"Dobbins, N",0,1,0,1,2
"Dobson, R",0,0,0,2,2
"Donsa, K",0,1,0,1,2
"Dorajoo, S",0,0,1,1,2
"Doutreligne, M",0,0,0,2,2
"Dumontier, M",0,0,0,2,2
"Ebert, M",0,0,2,0,2
"Eckardt, J",0,0,0,2,2
"Eckrich, D",0,0,0,2,2
"Edmondson, M",2,0,0,0,2
"Elbers, P",0,1,0,1,2
"Elovici, Y",2,0,0,0,2
"Englund, M",0,0,2,0,2
"Facchinello, C",1,0,0,1,2
"Fang, Y",0,1,1,0,2
"Farrell, A",0,0,1,1,2
"Feng, M",0,0,1,1,2
"Feng, Y",0,0,0,2,2
"Fernandez, S",0,0,2,0,2
"Ferrer, M",0,2,0,0,2
"Fina, F",0,0,2,0,2
"Fischer, P",0,1,0,1,2
"Fišter, K",0,0,2,0,2
"Flygare, O",0,2,0,0,2
"Fontana, T",1,0,1,0,2
"Fort, D",0,0,1,1,2
"Fouladvand, S",1,0,1,0,2
"Fraboulet, C",0,0,2,0,2
"Franceschini, D",0,0,2,0,2
"Francesconi, P",0,0,1,1,2
"Frazier, R",0,2,0,0,2
"Freedman, A",0,0,2,0,2
"Fruchart, M",0,0,0,2,2
"Furniss, D",0,0,2,0,2
"Gainer, V",1,0,0,1,2
"Garcia Morales, M",0,0,2,0,2
"Garza, M",0,1,0,1,2
"Gasman, S",0,1,1,0,2
"Giannini, J",0,0,0,2,2
"Gil Rojas, J",0,0,0,2,2
"Gold, S",0,0,0,2,2
"Gradinger, T",0,0,0,2,2
"Gratton, J",0,0,1,1,2
"Gregory, A",0,0,0,2,2
"Gribbon, P",0,0,0,2,2
"Griffon, N",0,0,0,2,2
"Guarner-Argente, C",0,0,2,0,2
"Guinney, J",0,0,2,0,2
"Gundler, C",1,0,0,1,2
"Gupta, A",0,0,1,1,2
"Gómez Rivas, J",1,0,1,0,2
"Günster, C",0,0,0,2,2
"Günther, A",0,1,0,1,2
"Haberson, A",0,0,0,2,2
"Hafeez, H",0,0,1,1,2
"Hague, C",0,0,1,1,2
"Hall, C",0,1,0,1,2
"Hall, N",0,0,2,0,2
"Hallinan, C",0,0,0,2,2
"Halvorson, A",0,0,2,0,2
"Hanauer, D",0,0,0,2,2
"Hauben, M",2,0,0,0,2
"Haverkamp, C",0,0,0,2,2
"Hayati, S",0,0,1,1,2
"Hayes, J",0,0,2,0,2
"Herings, R",2,0,0,0,2
"Hilka, M",0,0,0,2,2
"Hinske, L",0,0,2,0,2
"Hobbs, F",0,0,1,1,2
"Hoffmann, K",0,0,0,2,2
"Hogarth, M",0,0,1,1,2
"Holmes, J",1,0,0,1,2
"Hornig, M",0,0,2,0,2
"Horvitz, E",2,0,0,0,2
"Hruby, G",1,1,0,0,2
"Hu, Y",0,1,1,0,2
"Huang, C",0,0,1,1,2
"Huang, M",1,0,0,1,2
"Hubbard, R",1,0,1,0,2
"Hulsen, T",0,0,2,0,2
"Humphreys, K",1,0,1,0,2
"Hurwitz, N",0,0,2,0,2
"Husain, S",0,0,0,2,2
"Hwang, K",0,0,2,0,2
"Höning, G",0,0,0,2,2
"Imran Omar, M",1,0,1,0,2
"Innocenti, F",2,0,0,0,2
"Inoue, S",1,0,0,1,2
"Itzel, T",0,0,2,0,2
"Javaid, M",0,0,2,0,2
"Jayathissa, P",0,0,0,2,2
"Ji, H",0,0,0,2,2
"Ji, X",1,1,0,0,2
"Jiang, X",0,0,1,1,2
"Jin, H",0,0,2,0,2
"Jin, S",0,0,2,0,2
"Jing, N",2,0,0,0,2
"Johnson, K",0,1,1,0,2
"Johnston, S",1,0,1,0,2
"Jones, N",0,0,2,0,2
"Jonsson, P",0,0,1,1,2
"Joo, S",0,0,2,0,2
"Joo, Y",0,0,1,1,2
"Joss, M",0,1,0,1,2
"Joy, M",0,0,1,1,2
"Jung, H",0,0,1,1,2
"Kadengye, D",0,0,0,2,2
"Kang, D",1,0,1,0,2
"Kang, J",0,0,2,0,2
"Kanjala, C",0,0,0,2,2
"Kao Yang, Y",0,0,2,0,2
"Kapsner, L",0,1,0,1,2
"Karim, H",0,0,2,0,2
"Karlebach, G",1,0,1,0,2
"Kaspar, M",0,0,2,0,2
"Kawakami, Y",1,0,0,1,2
"Kelleher, K",1,0,1,0,2
"Khosla, S",0,0,2,0,2
"Kim, G",0,0,1,1,2
"Kim, I",0,0,2,0,2
"Kim, W",1,0,1,0,2
"Kimura, E",1,0,0,1,2
"Kingsbury, P",0,1,0,1,2
"Kiryluk, K",0,0,1,1,2
"Kizilaslan, B",0,2,0,0,2
"Ko, G",0,0,2,0,2
"Ko, Y",0,0,2,0,2
"Korntheuer, R",0,0,0,2,2
"Kramarz, P",0,0,2,0,2
"Kraska, D",0,0,0,2,2
"Krasteva, R",0,0,1,1,2
"Kremer, A",0,0,0,2,2
"Kullo, I",1,0,0,1,2
"Kurz, X",0,0,1,1,2
"Köhler, S",0,0,0,2,2
"Labarga, A",0,0,0,2,2
"Lam, I",0,0,2,0,2
"Lapi, F",0,0,1,1,2
"Larsen, R",0,2,0,0,2
"Latorre Moreno, L",0,2,0,0,2
"Lavallee, M",1,1,0,0,2
"Le Carrour, T",0,0,2,0,2
"Lea, D",0,1,0,1,2
"Lee, C",0,0,1,1,2
"Lee, N",0,2,0,0,2
"Leprovost, D",0,0,0,2,2
"Leutner, L",0,0,0,2,2
"Levine, M",1,0,0,1,2
"Li, R",1,0,0,1,2
"Li, Z",0,1,1,0,2
"Libanati, C",0,0,2,0,2
"Lim, H",1,0,1,0,2
"Lin, A",0,0,0,2,2
"Lin, H",0,0,0,2,2
"Lin, V",2,0,0,0,2
"Lingren, T",1,0,0,1,2
"Liu, L",0,0,2,0,2
"Liu, Q",1,0,0,1,2
"Liyanage, H",0,0,1,1,2
"Londhe, A",0,0,1,1,2
"Loomba, J",1,0,0,1,2
"Lorman, V",2,0,0,0,2
"Loste, C",0,0,2,0,2
"Lovestone, S",0,0,1,1,2
"Lozano-Rubí, R",0,0,0,2,2
"Lupattelli, A",0,0,1,1,2
"Lymperidou, A",0,0,0,2,2
"López-Blasco, R",0,0,2,0,2
"Lõo, M",0,0,0,2,2
"Ma, Q",0,0,0,2,2
"Macdonald, C",0,1,0,1,2
"Macho, P",0,2,0,0,2
"Madhira, V",0,1,1,0,2
"Magrini, S",0,0,2,0,2
"Markov, E",0,0,1,1,2
"Marsolo, K",0,0,0,2,2
"Marti, E",0,0,2,0,2
"Martinez-Hernandez, E",0,0,2,0,2
"Martínez-González, J",0,0,0,2,2
"Masood, E",0,1,0,1,2
"Mate, S",0,1,0,1,2
"Mathew, S",0,0,1,1,2
"Mayer, C",0,0,0,2,2
"Mazurie, A",0,0,2,0,2
"McClay, J",0,0,0,2,2
"McLemore, M",0,0,2,0,2
"Medina, M",0,0,2,0,2
"Mehlum, L",0,2,0,0,2
"Meininger, G",0,0,2,0,2
"Meléndez-Cardiel, J",0,0,2,0,2
"Mentch, F",1,0,0,1,2
"Mercier, G",0,0,2,0,2
"Miller, R",1,0,0,1,2
"Milligan, G",0,1,0,1,2
"Miotto, R",0,1,1,0,2
"Miron, V",0,0,2,0,2
"Modre-Osprian, R",0,1,0,1,2
"Mooney, S",0,1,1,0,2
"Mora, N",0,0,2,0,2
"Morgan Stewart, H",1,0,1,0,2
"Morgan-Cooper, H",0,0,2,0,2
"Morgan-Stewart, H",0,0,2,0,2
"Morhart, M",0,0,2,0,2
"Morris, A",0,0,0,2,2
"Morris, C",0,0,0,2,2
"Morris, M",0,0,1,1,2
"Mortier, P",0,2,0,0,2
"Moussa, M",0,0,0,2,2
"Mumtaz, S",0,1,0,1,2
"Murray, G",1,1,0,0,2
"Murri, R",0,0,2,0,2
"Nassirian, A",0,1,0,1,2
"Nelson, S",1,0,1,0,2
"Nesterow, I",0,0,0,2,2
"Neururer, S",0,1,0,1,2
"Ngiam, K",0,0,1,1,2
"Nissim, N",2,0,0,0,2
"Noll, R",1,0,0,1,2
"Oh, J",0,0,2,0,2
"Okajima, A",1,0,0,1,2
"Orhan, A",0,0,2,0,2
"Oskotsky, B",0,2,0,0,2
"Ostchega, Y",0,0,0,2,2
"Ottman, R",1,0,1,0,2
"Oyinlola, J",0,0,2,0,2
"Pan, G",1,0,1,0,2
"Panagi, V",0,1,0,1,2
"Pang, C",1,0,0,1,2
"Pasqua, A",0,0,1,1,2
"Pastor Duran, X",0,0,0,2,2
"Pastor, M",0,2,0,0,2
"Patel, L",0,0,0,2,2
"Patel, S",1,0,1,0,2
"Patterson, J",1,0,0,1,2
"Payralbe, S",0,0,0,2,2
"Pedersen, L",2,0,0,0,2
"Peissig, P",1,0,0,1,2
"Pellegrino, F",0,0,2,0,2
"Pfeifer, B",0,1,0,1,2
"Phan, T",0,0,2,0,2
"Picelli, G",2,0,0,0,2
"Pihoker, C",0,0,2,0,2
"Pletcher, M",0,0,2,0,2
"Prieto Alhambra, D",0,1,1,0,2
"Prinsen, P",0,0,2,0,2
"Prud'hommeaux, E",0,0,0,2,2
"Puente, D",0,0,2,0,2
"Pérez-Crespo, L",0,0,2,0,2
"Qian, Z",1,0,1,0,2
"Qin, P",0,2,0,0,2
"Quinlan, P",0,1,0,1,2
"Rajwa, P",1,0,1,0,2
"Ramirez, A",0,0,1,1,2
"Rappoport, N",1,1,0,0,2
"Razzaghi, H",0,0,1,1,2
"Rees, J",0,0,2,0,2
"Remmers, S",1,0,1,0,2
"Ribal, M",1,0,1,0,2
"Robinson, D",0,0,2,0,2
"Roh, Y",0,0,2,0,2
"Rohatsch, L",0,1,0,1,2
"Roobol, M",1,0,1,0,2
"Rosenberg, M",1,0,1,0,2
"Rouhizadeh, M",0,1,0,1,2
"Rubin, K",0,0,2,0,2
"Rudrapatna, V",0,2,0,0,2
"Rueda, M",0,1,0,1,2
"Ruhnke, T",0,0,0,2,2
"Rusanov, A",1,1,0,0,2
"Salmasian, H",0,0,1,1,2
"Saltz, J",1,0,1,0,2
"Schneider, H",0,2,0,0,2
"Schuler, A",1,0,1,0,2
"Schwinn, J",0,0,2,0,2
"Schüttler, J",0,0,0,2,2
"Sen, A",2,0,0,0,2
"Seneviratne, M",2,0,0,0,2
"Seol, S",0,0,2,0,2
"Serre, P",0,0,0,2,2
"Shahar, Y",2,0,0,0,2
"Shahn, Z",1,0,1,0,2
"Shao, Y",0,0,1,1,2
"Sheikhalishahi, S",0,0,2,0,2
"Shin, D",1,0,0,1,2
"Shin, H",1,0,1,0,2
"Shin, Y",0,0,2,0,2
"Sholle, E",0,1,0,1,2
"Si, Y",0,0,0,2,2
"Siapos, A",0,0,1,1,2
"Silverstein, J",0,1,0,1,2
"Singh, B",0,0,0,2,2
"Sivesind, T",0,0,2,0,2
"Smith, D",0,0,2,0,2
"Smith, E",0,0,2,0,2
"Smith, L",1,1,0,0,2
"Snijder, R",0,0,2,0,2
"Sohn, J",0,0,0,2,2
"Sohrabi, K",0,1,0,1,2
"Song, E",0,0,1,1,2
"Song, S",0,0,2,0,2
"Song, X",0,1,1,0,2
"Song, Y",0,0,2,0,2
"Spoden, M",0,0,0,2,2
"Stamm, T",0,0,0,2,2
"Stephens, K",0,1,1,0,2
"Stewart, L",0,1,1,0,2
"Straatman, H",2,0,0,0,2
"Stratmann, K",1,0,0,1,2
"Stöhr, M",0,0,0,2,2
"Sulieman, L",0,0,1,1,2
"Sun, F",0,0,1,1,2
"Sun, H",0,0,0,2,2
"Sung, J",0,0,2,0,2
"Sunwoo, L",1,0,0,1,2
"Swaminathan, S",0,0,1,1,2
"Szuldrzynski, K",0,0,2,0,2
"Särg, D",0,0,0,2,2
"Tak, Y",0,0,1,1,2
"Talvik, H",0,0,0,2,2
"Tamm, S",0,0,0,2,2
"Tan, H",0,0,1,1,2
"Tang, G",2,0,0,0,2
"Tannier, X",1,0,0,1,2
"Tarr, S",0,1,0,1,2
"Tavernier, B",0,0,0,2,2
"Taylor, R",0,0,1,1,2
"Tchetgen Tchetgen, E",1,0,1,0,2
"Teufel, A",0,0,2,0,2
"Thiel, J",0,0,0,2,2
"Thun, S",0,0,0,2,2
"Tiwari, P",1,0,1,0,2
"Toh, S",1,0,1,0,2
"Tohen, M",0,0,2,0,2
"Topaloglu, U",0,1,1,0,2
"Toth, E",0,0,2,0,2
"Tsafnat, G",0,0,0,2,2
"Tsiknakis, M",1,0,0,1,2
"Turkiewicz, A",0,0,2,0,2
"Twagirumukiza, M",0,0,0,2,2
"Umbel, K",0,0,1,1,2
"Urwin, E",0,1,0,1,2
"Valdivieso, B",0,0,2,0,2
"Valentini, G",1,0,1,0,2
"Valveny, N",0,0,2,0,2
"Vanguri, R",0,0,1,1,2
"Vaterkowski, M",1,0,0,1,2
"Vawdrey, D",0,0,1,1,2
"Vilagut, G",0,2,0,0,2
"Vilar, S",2,0,0,0,2
"Visweswaran, S",0,0,0,2,2
"Vojinovic, D",0,0,1,1,2
"Walbech, J",2,0,0,0,2
"Waldman, G",1,0,1,0,2
"Walters, K",0,0,0,2,2
"Walunas, T",1,0,0,1,2
"Wang, J",0,1,1,0,2
"Ward, R",0,0,0,2,2
"Weinreb, R",0,0,1,1,2
"Weissman, S",1,0,1,0,2
"Westlund, E",0,0,2,0,2
"White, R",2,0,0,0,2
"Wiest, I",0,0,2,0,2
"Wiley, K",1,0,0,1,2
"Williams, J",0,1,1,0,2
"Wooldridge, J",1,0,1,0,2
"Woong Park, R",0,0,2,0,2
"Xie, Y",0,0,1,1,2
"Xu, Z",0,2,0,0,2
"Yang, H",0,0,1,1,2
"Yang, Y",0,0,1,1,2
"Yao, L",0,0,0,2,2
"Yoon, E",0,0,0,2,2
"Yoon, H",0,0,2,0,2
"Yoon, S",1,0,0,1,2
"Young, S",1,0,1,0,2
"Youngerman, B",1,0,1,0,2
"Yum, Y",0,0,1,1,2
"Zampino, E",0,1,0,1,2
"Zelko, J",1,1,0,0,2
"Zeng, C",0,1,0,1,2
"Zhang, Q",0,0,2,0,2
"Zhang, R",0,0,0,2,2
"Zhu, V",0,0,1,1,2
"Zhu, Y",0,0,1,1,2
"Zhuk, O",0,0,2,0,2
"Zuo, X",0,0,0,2,2
"de Maeztu, G",0,0,2,0,2
"van Nuland, R",1,0,0,1,2
"Álvarez, E",1,0,0,1,2
"Álvarez-Lacalle, E",0,0,2,0,2
"Šuvalov, H",0,0,0,2,2
"Abad López, P",1,0,0,0,1
"Abajian, H",0,1,0,0,1
"Abajian, M",0,1,0,0,1
"Abbasi, F",0,0,1,0,1
"Abbasi, J",0,0,1,0,1
"Abbasizanjani, H",0,0,1,0,1
"Abedian, S",0,0,0,1,1
"Abedtash, H",0,0,1,0,1
"Abend, A",0,0,1,0,1
"Abou-Arab, O",0,0,0,1,1
"Abram, S",0,0,1,0,1
"Abrams, C",0,0,0,1,1
"Abu Attieh, H",0,1,0,0,1
"Abu-El-Rub, N",0,1,0,0,1
"Acharya, N",0,0,0,1,1
"Achtman, A",0,0,1,0,1
"Acker, T",0,0,0,1,1
"Adam, T",0,0,0,1,1
"Adams, M",0,1,0,0,1
"Adejumo, S",0,0,0,1,1
"Adelman, M",0,0,1,0,1
"Adibuzzaman, M",0,0,1,0,1
"Advani, S",0,0,1,0,1
"Afzal, M",0,0,0,1,1
"Agarwal, V",1,0,0,0,1
"Ageeva, I",0,1,0,0,1
"Agha, Z",0,0,1,0,1
"Agnew, J",0,0,0,1,1
"Agodi, A",0,0,1,0,1
"Agrawal, R",0,0,1,0,1
"Agüero, A",0,0,1,0,1
"Ahmad, F",0,1,0,0,1
"Ahmed, S",0,0,1,0,1
"Ahmedani, B",0,0,1,0,1
"Ahonen-Bishopp, A",0,0,0,1,1
"Aickelin, U",1,0,0,0,1
"Akashili, E",0,1,0,0,1
"Akbilgic, O",0,1,0,0,1
"Akinyemi, O",0,0,1,0,1
"Akiva, P",0,0,1,0,1
"Alba, M",0,0,1,0,1
"Alba, P",0,0,0,1,1
"Albarran, R",1,0,0,0,1
"Alberga, A",0,0,1,0,1
"Alberti, A",0,0,1,0,1
"Alcalde-Herraiz, M",0,0,1,0,1
"Alcorn, C",0,0,0,1,1
"Ali, R",0,0,1,0,1
"Ali, S",0,0,1,0,1
"Alkasab, T",0,0,0,1,1
"Allery, F",0,0,1,0,1
"Allou, N",0,0,0,1,1
"Allyn, J",0,0,0,1,1
"Almeida, T",0,1,0,0,1
"Alnofal, F",0,0,0,1,1
"Alonso, E",0,0,0,1,1
"Alonso-Arce, M",0,0,0,1,1
"Alphs, L",0,0,1,0,1
"Alrouh, H",0,0,0,1,1
"Alrwisan, A",0,0,0,1,1
"Alshammary, T",0,0,1,0,1
"Altun, F",0,1,0,0,1
"Aluthge, D",0,0,0,1,1
"Alvarado-Guzman, J",0,0,0,1,1
"Amarasekera, D",0,0,0,1,1
"Amerali, M",0,0,1,0,1
"Amin, R",0,0,0,1,1
"Amirthalingam, G",0,0,1,0,1
"Ammann, E",0,0,1,0,1
"Ammar, N",1,0,0,0,1
"Ammour, N",0,0,1,0,1
"Amrollahi, F",1,0,0,0,1
"An, J",1,0,0,0,1
"An, M",1,0,0,0,1
"Anand, S",0,0,0,1,1
"Anandan, L",0,0,0,1,1
"Anderson, K",0,0,0,1,1
"Anderson, W",0,0,1,0,1
"Anderson-Mellies, A",0,0,0,1,1
"Andeso, P",0,0,0,1,1
"Andre, J",0,0,0,1,1
"Andrés, C",0,0,1,0,1
"Ang, P",0,0,0,1,1
"Angyan, P",0,1,0,0,1
"Ansolabehere, X",0,0,0,1,1
"Antognoni, P",0,0,1,0,1
"Antonescu, C",1,0,0,0,1
"Antony, B",1,0,0,0,1
"Antón, A",0,0,1,0,1
"Anyanwu-Ofili, A",0,0,1,0,1
"Aoyagi, Y",0,0,0,1,1
"Apfel-Starke, J",0,0,0,1,1
"Appenteng, K",0,0,1,0,1
"Aragon, L",0,0,1,0,1
"Aran, D",1,0,0,0,1
"Araujo, S",0,0,0,1,1
"Arboleda-Velasquez, J",0,0,1,0,1
"Areaux, R",0,0,1,0,1
"Argenziano, M",0,0,1,0,1
"Ariosa, R",0,0,0,1,1
"Arlett, P",0,0,0,1,1
"Armbrust, K",0,0,1,0,1
"Arnold, M",0,0,1,0,1
"Aronson, J",1,0,0,0,1
"Aruch, D",1,0,0,0,1
"Asch, S",1,0,0,0,1
"Ashish, N",0,0,0,1,1
"Asikainen, S",0,0,1,0,1
"Aubele, F",0,1,0,0,1
"Austin, C",0,0,1,0,1
"Autexier, S",0,0,0,1,1
"Avramidis, I",0,0,0,1,1
"Baba, M",0,0,0,1,1
"Bachir, S",0,0,0,1,1
"Bacry, E",1,0,0,0,1
"Badgeley, M",0,1,0,0,1
"Bae, H",0,0,1,0,1
"Bae, J",0,0,1,0,1
"Bae, W",0,0,1,0,1
"Baek, R",0,0,0,1,1
"Bagyura, Z",0,0,0,1,1
"Bahati, O",0,0,0,1,1
"Bailey, C",0,1,0,0,1
"Baillie, I",0,0,0,1,1
"Baillie, J",0,0,0,1,1
"Bak, S",0,0,1,0,1
"Bakare, T",0,0,1,0,1
"Baker, C",0,0,0,1,1
"Bakken, S",0,0,1,0,1
"Balaur, I",0,0,0,1,1
"Balcaen, T",0,0,0,1,1
"Baldwin, L",0,0,1,0,1
"Balharry, D",0,0,0,1,1
"Banerjee, A",0,0,1,0,1
"Banerjee, J",1,0,0,0,1
"Bang, C",0,0,1,0,1
"Bang, J",0,0,1,0,1
"Banokina, T",0,0,0,1,1
"Bao, W",1,0,0,0,1
"Barapatre, S",0,1,0,0,1
"Barbieri, J",0,0,1,0,1
"Barchitta, M",0,0,1,0,1
"Barkmeier, A",0,0,1,0,1
"Barnett, D",0,0,0,1,1
"Barraca, J",1,0,0,0,1
"Barreto, M",0,0,0,1,1
"Bartels, M",0,0,0,1,1
"Bartels, S",0,0,0,1,1
"Bartlett, V",1,0,0,0,1
"Barton, A",0,1,0,0,1
"Bartschke, A",0,0,0,1,1
"Bashir, A",0,0,0,1,1
"Basile, A",0,0,1,0,1
"Bassileiades, N",0,0,0,1,1
"Bastani, A",0,0,1,0,1
"Bastarache, L",0,0,0,1,1
"Bastian, G",0,1,0,0,1
"Batch, A",0,0,0,1,1
"Bates, B",0,0,1,0,1
"Bates, C",0,0,1,0,1
"Baudis, M",0,0,0,1,1
"Bauer-Mehren, A",1,0,0,0,1
"Bazakou, S",0,0,0,1,1
"Beaulieu-Jones, B",0,0,0,1,1
"Beccia, A",0,1,0,0,1
"Beck, T",0,0,0,1,1
"Bedrick, S",0,1,0,0,1
"Bedston, S",0,0,0,1,1
"Beers-Mulroy, B",0,0,1,0,1
"Begum, S",0,1,0,0,1
"Behrens, M",0,1,0,0,1
"Belbin, G",0,0,1,0,1
"Bellamine, A",0,0,0,1,1
"Bellas, L",0,0,0,1,1
"Bellasi, A",0,0,0,1,1
"Bellazzi, R",0,0,0,1,1
"Belmans, L",0,0,1,0,1
"Beltramo, G",0,0,1,0,1
"Benis, N",0,0,0,1,1
"Benoit, V",0,0,0,1,1
"Benscoter, D",0,0,0,1,1
"Beran, M",0,0,0,1,1
"Berenguera, A",0,0,1,0,1
"Berger, A",1,0,0,0,1
"Berger, F",0,0,0,1,1
"Bergvall, T",1,0,0,0,1
"Bermejo, I",0,0,0,1,1
"Bernal, F",0,0,0,1,1
"Bernal, J",0,0,0,1,1
"Bernaux, M",0,0,0,1,1
"Berni, R",0,0,0,1,1
"Bernstam, E",0,0,0,1,1
"Berry, S",0,0,1,0,1
"Berti-Equille, L",1,0,0,0,1
"Bertizzolo, L",0,0,1,0,1
"Bertoch, D",0,0,0,1,1
"Bertolini, G",1,0,0,0,1
"Bertz, J",0,0,1,0,1
"Bessler, M",0,0,1,0,1
"Best, J",0,0,0,1,1
"Bethusamy, S",0,0,0,1,1
"Bey, R",0,0,0,1,1
"Bezemer, I",0,0,1,0,1
"Bezer, J",1,0,0,0,1
"Bhanvadia, S",0,0,0,1,1
"Bhatia, A",0,0,1,0,1
"Bhullar, H",0,0,0,1,1
"Bhuyan, P",0,0,1,0,1
"Bianchini, E",0,0,0,1,1
"Bieber, R",0,0,0,1,1
"Bierma-Zeinstra, S",0,0,1,0,1
"Bigaki, M",0,0,0,1,1
"Bikdeli, B",0,0,1,0,1
"Binder, H",0,0,0,1,1
"Birced, I",0,0,0,1,1
"Birhanu, M",0,0,0,1,1
"Birlie, B",0,0,1,0,1
"Birungi, F",0,0,0,1,1
"Bisyuk, Y",0,0,1,0,1
"Bivas-Benita, M",0,0,1,0,1
"Bizimana, C",0,0,0,1,1
"Black, R",0,1,0,0,1
"Black, S",0,0,1,0,1
"Blackwell, W",0,0,1,0,1
"Blagec, K",0,0,1,0,1
"Blanco, I",0,0,1,0,1
"Blay, J",0,0,1,0,1
"Blei, D",1,0,0,0,1
"Blosnich, J",0,0,1,0,1
"Blum, N",0,0,1,0,1
"Bodenreider, O",1,0,0,0,1
"Body, J",0,0,1,0,1
"Boerries, M",0,0,0,1,1
"Bohm, A",0,1,0,0,1
"Bohn, J",1,0,0,0,1
"Boiten, J",1,0,0,0,1
"Bojesen, R",0,0,1,0,1
"Bompelli, A",0,0,0,1,1
"Bonadt, K",0,0,0,1,1
"Bonfanti, P",0,0,1,0,1
"Bonhoeffer, J",1,0,0,0,1
"Bonmati, L",0,0,0,1,1
"Booth, D",0,0,0,1,1
"Booth, H",0,0,1,0,1
"Bordoy, A",0,0,1,0,1
"Borkowetz, A",0,0,1,0,1
"Bornhäuser, M",0,0,0,1,1
"Borrat Frigola, X",0,0,0,1,1
"Bosari, S",0,0,0,1,1
"Bosco, C",1,0,0,0,1
"Bosma, G",0,0,1,0,1
"Bosworth, A",0,0,1,0,1
"Boudis, F",0,1,0,0,1
"Bourgeois, A",0,0,0,1,1
"Bouvy, J",0,0,0,1,1
"Bove, A",0,0,0,1,1
"Boxwala, A",0,0,0,1,1
"Boyce, D",0,0,1,0,1
"Boyer, L",0,0,1,0,1
"Bozkurt, L",0,0,1,0,1
"Bradenday, J",0,0,1,0,1
"Bradford, R",0,0,0,1,1
"Brand, J",0,0,1,0,1
"Branda, M",0,0,1,0,1
"Brandi, M",0,0,1,0,1
"Brat, G",0,0,0,1,1
"Brauer, R",0,0,0,1,1
"Braunstein, M",0,1,0,0,1
"Bray, B",0,1,0,0,1
"Breeze, T",0,0,0,1,1
"Briggs, J",0,0,1,0,1
"Briskin, E",0,0,1,0,1
"Britt, B",0,1,0,0,1
"Britten, C",1,0,0,0,1
"Brobert, G",0,0,1,0,1
"Bron, E",0,0,0,1,1
"Brookes, A",0,0,0,1,1
"Brooks, A",0,0,0,1,1
"Brooks, J",1,0,0,0,1
"Brosa, M",0,0,1,0,1
"Brouwer, E",1,0,0,0,1
"Brown, E",0,0,1,0,1
"Brown, K",0,0,0,1,1
"Bruandet, A",0,1,0,0,1
"Brunelli, L",0,1,0,0,1
"Bruni, A",0,0,1,0,1
"Brusselle, G",0,0,1,0,1
"Bucalo, M",0,0,0,1,1
"Buchowicz, K",0,1,0,0,1
"Buesgens, N",1,0,0,0,1
"Buglione, M",0,0,1,0,1
"Bui, M",0,0,1,0,1
"Bulut, M",1,0,0,0,1
"Bunker, D",0,0,0,1,1
"Buresh, J",1,0,0,0,1
"Burgun, A",0,0,0,1,1
"Burke, B",0,0,0,1,1
"Burmann, A",0,0,0,1,1
"Burnett, S",0,0,1,0,1
"Burns, A",0,0,0,1,1
"Burns, F",0,0,0,1,1
"Busch, D",0,0,0,1,1
"Buse, J",0,0,1,0,1
"Bush, B",0,0,0,1,1
"Butler, C",0,0,1,0,1
"Buy, M",0,0,0,1,1
"Buzquurz, F",0,0,1,0,1
"Byeon, G",0,0,1,0,1
"Byrd, J",0,0,1,0,1
"Byttebier, G",0,0,1,0,1
"Byun, J",0,0,1,0,1
"Bönisch, C",0,0,0,1,1
"C Rancourt, R",0,0,0,1,1
"Cabornero, G",0,0,0,1,1
"Cadenas Juanino, H",0,0,1,0,1
"Cai, B",0,0,0,1,1
"Cai, L",0,0,1,0,1
"Cai, R",0,0,1,0,1
"Cai, T",0,0,0,1,1
"Calafiore, M",0,0,0,1,1
"Caldwell, J",0,0,0,1,1
"Calligan, M",0,0,0,1,1
"Campbell, B",1,0,0,0,1
"Campbell, H",0,0,0,1,1
"Campbell, W",0,0,0,1,1
"Camprubi, M",0,0,0,1,1
"Canakis, A",0,0,1,0,1
"Candore, G",0,0,0,1,1
"Canham, S",1,0,0,0,1
"Canoy, D",0,0,1,0,1
"Canuso, C",0,0,1,0,1
"Cao, A",0,0,0,1,1
"Caparrós-Redondo, M",0,0,0,1,1
"Cappella, N",0,0,0,1,1
"Capurro, D",0,0,0,1,1
"Carbonari, D",0,0,1,0,1
"Carceller, H",0,0,0,1,1
"Cardona, P",0,0,1,0,1
"Cardoso, I",0,0,1,0,1
"Carencotte, R",0,0,0,1,1
"Carević, B",0,0,1,0,1
"Carini, S",0,0,0,1,1
"Carlini, E",0,0,1,0,1
"Carmona, L",1,0,0,0,1
"Carnahan, R",1,0,0,0,1
"Caroll, R",1,0,0,0,1
"Carpenter, A",0,0,0,1,1
"Carr, A",1,0,0,0,1
"Carr, R",0,0,1,0,1
"Carvel, A",0,0,0,1,1
"Casasayas, M",0,0,1,0,1
"Case, A",1,0,0,0,1
"Castro, P",0,0,1,0,1
"Castro, V",0,0,0,1,1
"Catalano, G",0,0,1,0,1
"Cates, A",0,1,0,0,1
"Cats, D",0,0,0,1,1
"Caucheteux, C",0,0,0,1,1
"Caufield, J",1,0,0,0,1
"Cavanaugh, R",0,1,0,0,1
"Cave, A",0,0,0,1,1
"Cazzola, W",0,0,0,1,1
"Chahed, H",0,0,0,1,1
"Chakravarty, A",1,0,0,0,1
"Chalabi, E",0,0,1,0,1
"Chamberlain, A",0,0,0,1,1
"Champ, J",0,0,0,1,1
"Chan, L",0,0,1,0,1
"Chan, M",0,0,1,0,1
"Chandler, R",1,0,0,0,1
"Chandran, U",1,0,0,0,1
"Chang, J",0,0,0,1,1
"Chang, S",0,0,1,0,1
"Chang, W",0,0,1,0,1
"Chapman, W",0,1,0,0,1
"Chard, T",0,0,0,1,1
"Chatburn, R",0,0,0,1,1
"Chatellier, G",0,0,0,1,1
"Chatzidionysiou, K",1,0,0,0,1
"Chaudhari, D",0,0,0,1,1
"Chen, C",0,0,1,0,1
"Chen, F",0,0,1,0,1
"Chen, Q",0,0,1,0,1
"Chen, S",0,0,0,1,1
"Cheng, A",0,0,1,0,1
"Cheng, F",1,0,0,0,1
"Cheng, M",1,0,0,0,1
"Cheng, X",1,0,0,0,1
"Cheng, Y",0,0,1,0,1
"Cheung, Y",0,0,1,0,1
"Chhokar, R",0,0,1,0,1
"Chi, Y",1,0,0,0,1
"Chidgey, C",0,0,0,1,1
"Chiesa-Estomba, C",0,0,1,0,1
"Chilelli, A",0,0,1,0,1
"Chiovato, L",0,0,0,1,1
"Chisolm, D",0,0,1,0,1
"Cho, E",0,0,1,0,1
"Cho, Y",0,0,1,0,1
"Choate, K",0,0,1,0,1
"Choe, S",1,0,0,0,1
"Choe, Y",0,0,1,0,1
"Choi, K",0,0,1,0,1
"Choi, M",0,1,0,0,1
"Chomutare, T",0,0,0,1,1
"Chowers, Y",0,0,1,0,1
"Christensen, L",0,1,0,0,1
"Christensen, R",0,0,1,0,1
"Christoph, J",0,0,0,1,1
"Christopher, M",0,0,0,1,1
"Chu, H",1,0,0,0,1
"Chu, S",0,0,0,1,1
"Chuang, A",0,0,0,1,1
"Chun, A",0,0,0,1,1
"Chun, H",0,0,1,0,1
"Chun, I",0,0,1,0,1
"Chun, K",0,0,1,0,1
"Chung, J",0,0,1,0,1
"Chung, L",0,0,1,0,1
"Claire, R",0,0,1,0,1
"Clavier, T",0,0,0,1,1
"Clement, G",0,1,0,0,1
"Coates, L",0,0,1,0,1
"Cocoros, N",0,0,1,0,1
"Cohen, I",0,0,0,1,1
"Cohen, J",0,0,1,0,1
"Cohen, T",1,0,0,0,1
"Colaert, D",0,0,0,1,1
"Colahan, C",0,0,0,1,1
"Collins, C",0,0,0,1,1
"Collins, J",0,0,0,1,1
"Collison-Farr, K",0,0,0,1,1
"Colvin, R",0,0,0,1,1
"Coma Redon, E",0,0,1,0,1
"Connell, D",0,0,0,1,1
"Connellan, C",1,0,0,0,1
"Connolly, J",0,0,1,0,1
"Constantinovici, N",0,0,1,0,1
"Contrino, S",1,0,0,0,1
"Conway, M",0,1,0,0,1
"Cook, J",0,0,1,0,1
"Cook, S",0,0,0,1,1
"Coplan, P",0,0,0,1,1
"Coppola, M",0,0,0,1,1
"Cordomi, S",0,0,1,0,1
"Cormont, S",0,0,0,1,1
"Coronado, G",0,0,0,1,1
"Cossin, S",0,0,0,1,1
"Costa, M",0,0,1,0,1
"Costa, V",1,0,0,0,1
"Costello, R",0,0,1,0,1
"Coudert, M",0,0,1,0,1
"Craig, J",0,0,0,1,1
"Crameri, K",0,0,0,1,1
"Crandall, K",0,0,0,1,1
"Cremonesi, F",0,0,0,1,1
"Crew, K",0,0,1,0,1
"Crews, D",0,0,1,0,1
"Cricelli, C",0,0,0,1,1
"Crimmins, N",0,0,0,1,1
"Crisanti, A",0,0,1,0,1
"Crochet, H",0,0,1,0,1
"Cronin, R",0,0,1,0,1
"Crooks, M",0,0,0,1,1
"Crosslin, D",0,0,0,1,1
"Crowley, K",0,0,0,1,1
"Cruz, J",0,0,0,1,1
"Cruz-Correia, R",0,0,0,1,1
"Cui, G",1,0,0,0,1
"Culliford, D",0,0,1,0,1
"Cummins, M",0,0,1,0,1
"Curtin, C",1,0,0,0,1
"Custers, I",1,0,0,0,1
"Cuthbert, A",1,0,0,0,1
"Cuticchia, J",0,1,0,0,1
"Dabrera, G",0,0,1,0,1
"Dahl, M",0,0,1,0,1
"Dai, J",0,0,0,1,1
"Dai, Z",0,0,1,0,1
"Daketi, V",0,0,0,1,1
"Dale, L",0,0,0,1,1
"Dalmiani, S",0,0,0,1,1
"Daly, O",0,0,0,1,1
"Danciu, G",0,0,0,1,1
"Dandala, B",1,0,0,0,1
"Dang, T",0,0,0,1,1
"Daniar, M",0,0,0,1,1
"Dasher, P",0,0,1,0,1
"Datseris, G",0,1,0,0,1
"Daumke, P",0,0,0,1,1
"Davatzikos, C",0,1,0,0,1
"Davenport, M",1,0,0,0,1
"David, R",1,0,0,0,1
"Davidson, L",0,0,0,1,1
"Davies, B",0,0,0,1,1
"Davies, E",0,0,1,0,1
"Davies, S",0,0,0,1,1
"Davis, H",1,0,0,0,1
"Davis, K",0,0,1,0,1
"Davis, M",0,1,0,0,1
"Day, M",0,0,1,0,1
"Dazzi, P",0,0,1,0,1
"De La Iglesia-Vayá, M",0,0,0,1,1
"De Meyer, R",0,0,0,1,1
"De Roo, J",0,0,0,1,1
"De Vloed, B",0,0,0,1,1
"DeFor, T",0,0,1,0,1
"DeKlotz, C",0,0,1,0,1
"DeWitt, P",0,0,1,0,1
"Deakyne Davies, S",0,0,0,1,1
"Deans, K",0,0,0,1,1
"Defebvre, M",0,0,0,1,1
"Dekermanjian, J",0,0,1,0,1
"Dekker, A",0,0,0,1,1
"Del Beccaro, M",0,0,0,1,1
"Del Fiol, G",0,0,0,1,1
"Delanerolle, G",0,0,0,1,1
"Delitto, A",0,0,0,1,1
"Dell'Isola, A",0,0,1,0,1
"Dell'Oca, I",0,0,1,0,1
"Demelius, L",0,1,0,0,1
"Deng, H",0,0,1,0,1
"Denham, A",0,0,1,0,1
"Depas, N",0,0,0,1,1
"Deppen, S",0,0,0,1,1
"Depraetere, K",0,0,0,1,1
"Derian, N",0,0,1,0,1
"Dermentzoglou, L",0,0,0,1,1
"Desai, R",0,0,1,0,1
"Descamps, F",0,0,0,1,1
"Destin, B",0,0,1,0,1
"Devkota, B",0,0,0,1,1
"Dexheimer, J",0,0,0,1,1
"Dhaenens, B",0,0,1,0,1
"Dhombres, F",1,0,0,0,1
"Di Angelantonio, E",0,0,0,1,1
"Di Muzio, N",0,0,1,0,1
"DiBattiste, P",0,0,1,0,1
"Diallo, G",0,0,0,1,1
"Diallo, I",1,0,0,0,1
"Diao, Z",0,0,0,1,1
"Diaz Holgado, A",0,0,1,0,1
"Diaz, L",0,0,1,0,1
"Dickinson, S",0,0,1,0,1
"Dieterle, N",0,0,0,1,1
"Diez-Perez, A",0,0,1,0,1
"Digan, W",0,0,0,1,1
"Dimitrov, L",0,0,0,1,1
"Ding, J",0,0,0,1,1
"Ding, K",1,0,0,0,1
"Ding, X",0,0,1,0,1
"Ding, Y",0,1,0,0,1
"Dissemond, J",0,0,0,1,1
"Dixon, B",0,1,0,0,1
"Djaballah, K",0,0,1,0,1
"Djibo, D",0,0,1,0,1
"Do, J",0,0,1,0,1
"Doctor, J",0,0,1,0,1
"Dodsley, C",0,0,0,1,1
"Dohrn, N",1,0,0,0,1
"Dolan, B",0,0,0,1,1
"Dolan, L",0,0,1,0,1
"Domenech-Fernández, J",0,0,0,1,1
"Donahoo, W",0,0,1,0,1
"Donatini, A",0,0,1,0,1
"Doney, A",0,0,0,1,1
"Dong, S",0,0,1,0,1
"Dong, X",0,0,0,1,1
"Dong, Y",0,0,1,0,1
"Dongelmans, D",0,0,0,1,1
"Donovan, D",0,0,1,0,1
"Dorn, C",0,0,1,0,1
"Dorward, J",0,0,1,0,1
"Doshi, A",0,0,0,1,1
"Doshi, J",1,0,0,0,1
"Doublet, M",0,0,0,1,1
"Downs, S",0,0,1,0,1
"Drew, S",1,0,0,0,1
"Driessen, S",0,0,1,0,1
"Drozda, J",0,0,0,1,1
"Duarte-Sales, T",0,0,1,0,1
"Dubiel, J",0,0,0,1,1
"Dubois, R",1,0,0,0,1
"Dubois, S",0,0,1,0,1
"Dubreuil, M",0,0,1,0,1
"Duclos, C",1,0,0,0,1
"Dunscombe, R",0,0,0,1,1
"Durand, T",0,0,1,0,1
"Durate-Salles, T",0,0,1,0,1
"Dutcher, S",0,0,1,0,1
"Dávila-García, D",0,0,1,0,1
"Düsseldorf, H",0,0,0,1,1
"Eavis, A",0,0,1,0,1
"Ehrlich, J",0,0,1,0,1
"Eid, S",0,0,1,0,1
"Eils, R",0,0,0,1,1
"Eisenstein, A",0,0,1,0,1
"Eisman, A",0,0,0,1,1
"El Ghosh, M",1,0,0,0,1
"Elder, R",0,0,1,0,1
"Elhussein, A",0,0,0,1,1
"Elhussein, L",0,0,1,0,1
"Elia, J",0,0,1,0,1
"Elias, P",0,0,1,0,1
"Elkin, P",0,1,0,0,1
"Elkind, M",0,0,1,0,1
"Elliot, A",0,0,1,0,1
"Elliston, K",0,1,0,0,1
"Elmqvist, N",0,0,0,1,1
"Eltinge, S",0,0,0,1,1
"Elvidge, J",0,0,1,0,1
"Embree, K",0,0,0,1,1
"Empey, P",0,0,1,0,1
"Ena, L",0,0,1,0,1
"Engelmann, K",0,0,0,1,1
"English, L",0,0,0,1,1
"Erasmus, H",0,0,0,1,1
"Erdogan, B",0,0,1,0,1
"Erfurt-Berge, C",0,0,0,1,1
"Erpenbeck, M",0,0,0,1,1
"Escribà-Montagut, X",0,1,0,0,1
"Espejo, M",0,0,0,1,1
"Essaid, S",0,0,0,1,1
"Esteve, L",0,0,0,1,1
"Estiri, H",0,0,0,1,1
"Ethier, J",0,1,0,0,1
"Etropolski, M",0,0,1,0,1
"Eun, Y",0,0,1,0,1
"Ewart, C",0,0,0,1,1
"Ewbank, J",1,0,0,0,1
"Eyre, D",0,0,0,1,1
"Fabre, A",0,0,0,1,1
"Fabry, P",0,1,0,0,1
"Facey, K",0,0,1,0,1
"Fakhouri, W",1,0,0,0,1
"Falgenhauer, M",0,0,0,1,1
"Fan, M",0,0,1,0,1
"Fan, R",0,0,1,0,1
"Far, A",0,0,1,0,1
"Farjat, A",0,0,1,0,1
"Farmaki, A",0,0,1,0,1
"Farshid, S",0,0,0,1,1
"Farzaneh, S",0,0,0,1,1
"Fazli, M",0,0,1,0,1
"Fecho, K",0,1,0,0,1
"Fedorov, A",0,1,0,0,1
"Feher, M",0,0,1,0,1
"Feinstein, J",0,0,0,1,1
"Feng, Q",0,0,1,0,1
"Feng, X",0,0,1,0,1
"Ferdynus, C",0,0,0,1,1
"Fernandez-Chas, M",1,0,0,0,1
"Ferner, R",1,0,0,0,1
"Fernández Bertolín, S",0,0,1,0,1
"Ferrandiz-Espadin, R",0,0,1,0,1
"Ferrari, S",0,0,1,0,1
"Ferreira, F",0,0,1,0,1
"Ficheur, G",0,0,0,1,1
"Filion, K",0,0,0,1,1
"Filippone, C",1,0,0,0,1
"Fillion-Robin, J",0,1,0,0,1
"Fina Avilés, F",0,0,1,0,1
"Finkelstein, J",0,0,0,1,1
"Finster, M",0,0,0,1,1
"Fiorentino, D",0,0,1,0,1
"Fischer, A",0,0,0,1,1
"Fishbein, H",0,0,1,0,1
"Fisher, R",1,0,0,0,1
"FitzHenry, F",0,0,0,1,1
"Flach, C",0,0,1,0,1
"Fleuren, L",0,1,0,0,1
"Flores-Ortiz, R",0,0,0,1,1
"Flowers, A",0,0,1,0,1
"Fodor, A",0,0,1,0,1
"Follett, R",0,0,0,1,1
"Folz, M",0,1,0,0,1
"Forbes, A",0,0,0,1,1
"Forsyth, T",0,0,0,1,1
"Fortin, B",0,0,1,0,1
"Foster, I",0,1,0,0,1
"Fotiadis, D",0,0,0,1,1
"Fox, C",0,0,0,1,1
"Fraas, S",0,0,0,1,1
"Fradziak, M",0,0,0,1,1
"Fram, D",0,0,1,0,1
"Frank, M",0,0,0,1,1
"Franzese, C",0,0,1,0,1
"Freburger, J",0,0,0,1,1
"Freeberg, M",1,0,0,0,1
"French, M",0,0,0,1,1
"Frias, J",0,0,1,0,1
"Friedman, A",1,0,0,0,1
"Frischen, L",0,0,0,1,1
"Fritsch, H",0,0,0,1,1
"Fromont, L",0,0,0,1,1
"Fu, S",0,0,0,1,1
"Fuentes, A",1,0,0,0,1
"Fuentes, L",0,1,0,0,1
"Fuhrmann, S",0,0,0,1,1
"Gacci, M",0,0,1,0,1
"Gacquer, W",0,0,0,1,1
"Gadiya, Y",0,0,0,1,1
"Gaffney, M",1,0,0,0,1
"Gagnidze, G",0,0,0,1,1
"Gall, H",0,0,0,1,1
"Gallant, S",0,0,0,1,1
"Gallego, B",0,0,0,1,1
"Galstyan, G",0,0,1,0,1
"Galvan, Y",0,0,1,0,1
"Gan, S",0,0,1,0,1
"Gansel, X",0,0,0,1,1
"Gao, J",1,0,0,0,1
"Gao, S",0,0,0,1,1
"Gao, W",0,0,1,0,1
"Garbe, E",0,0,0,1,1
"Garcelon, N",0,0,0,1,1
"Garcia, J",0,1,0,0,1
"Garcia, N",0,0,0,1,1
"García Barrio, N",0,0,1,0,1
"García-Bastida, C",0,0,1,0,1
"García-García, F",0,0,0,1,1
"Gardner, H",0,0,0,1,1
"Garg, V",0,0,1,0,1
"Gargano, M",1,0,0,0,1
"Garibaldi, B",0,0,1,0,1
"Garibaldi, J",1,0,0,0,1
"Garin-Muga, A",0,0,0,1,1
"Gates, K",0,1,0,0,1
"Gatsby, E",0,0,1,0,1
"Gaudet-Blavignac, C",0,0,0,1,1
"Gauffin, O",0,0,1,0,1
"Gavriilidis, G",0,0,1,0,1
"Gehlenborg, N",0,0,0,1,1
"Genereaux, B",0,0,0,1,1
"Geneslaw, A",0,0,1,0,1
"Geng, M",0,0,1,0,1
"Gentilin, S",0,1,0,0,1
"Gentine, P",0,0,1,0,1
"George, H",0,0,0,1,1
"George, M",0,0,1,0,1
"Gerardi, M",0,0,1,0,1
"Gersing, K",0,0,1,0,1
"Gertzog, M",0,0,0,1,1
"Gezgin, D",0,0,0,1,1
"Ghosh, D",0,0,1,0,1
"Ghosh, S",0,0,0,1,1
"Ghumman, N",1,0,0,0,1
"Gibson, J",1,0,0,0,1
"Gierschner, C",0,0,0,1,1
"Gifford, A",0,0,0,1,1
"Gifkins, D",1,0,0,0,1
"Giladi, A",0,0,1,0,1
"Gilbert, Z",0,0,1,0,1
"Gilbertson, J",0,1,0,0,1
"Giles, T",0,0,0,1,1
"Gillberg, J",0,0,0,1,1
"Gillen, K",0,0,0,1,1
"Gillson, N",0,0,0,1,1
"Giménez, A",0,1,0,0,1
"Girani, E",0,1,0,0,1
"Gisladottir, U",0,0,1,0,1
"Giubbolini, R",0,0,1,0,1
"Giudice, L",0,0,1,0,1
"Giuste, F",0,0,0,1,1
"Gjoni, K",0,0,1,0,1
"Gkaliagkousi, E",0,0,1,0,1
"Glanz, J",0,0,0,1,1
"Glaser, S",0,0,0,1,1
"Glatt, N",0,0,0,1,1
"Glowe, P",0,0,1,0,1
"Gobbel, G",0,1,0,0,1
"Goel, K",0,0,1,0,1
"Goel, R",0,0,0,1,1
"Goel, V",1,0,0,0,1
"Goerg, C",0,0,0,1,1
"Goff, S",0,0,0,1,1
"Goldstein, A",1,0,0,0,1
"Goldstein, D",0,0,1,0,1
"Goldstein, M",1,0,0,0,1
"Goldstein, T",0,1,0,0,1
"Gologorskaya, O",0,0,1,0,1
"Golovko, G",0,0,0,1,1
"Golriz Khatami, S",0,0,0,1,1
"Gombar, S",0,1,0,0,1
"Gomez-Rivas, J",0,0,1,0,1
"Gonul, S",0,0,0,1,1
"Gonzalez, S",0,0,1,0,1
"González, J",0,1,0,0,1
"Goodrich, C",0,1,0,0,1
"Goovaerts, H",0,0,1,0,1
"Gorbachev, A",0,0,0,1,1
"Gorse, J",0,0,0,1,1
"Gotz, D",0,0,0,1,1
"Gouripeddi, R",0,0,0,1,1
"Goyal, P",0,0,0,1,1
"Goyer, F",0,1,0,0,1
"Graham, D",0,0,0,1,1
"Gramfort, A",0,0,0,1,1
"Grammatikopoulou, M",0,0,1,0,1
"Grammes, J",0,0,1,0,1
"Grannis, S",0,1,0,0,1
"Gray, J",0,1,0,0,1
"Greaves, P",0,0,0,1,1
"Greco, C",0,0,1,0,1
"Greevy, R",0,0,1,0,1
"Gregg, E",0,0,1,0,1
"Grieve, G",0,0,0,1,1
"Griffiths, K",0,0,1,0,1
"Grisel, O",0,0,0,1,1
"Grube, C",0,0,1,0,1
"Gruendner, J",0,0,0,1,1
"Grummt, S",0,0,0,1,1
"Gründner, J",0,0,0,1,1
"Gu, Y",0,0,0,1,1
"Guan, Y",0,0,1,0,1
"Guengoeze, O",0,0,0,1,1
"Guerin, J",0,0,0,1,1
"Guerin, P",0,0,1,0,1
"Guo, C",0,0,1,0,1
"Guo, G",0,0,0,1,1
"Guo, L",0,0,0,1,1
"Gupta, S",0,0,0,1,1
"Gut, I",0,1,0,0,1
"Gutierrez, M",0,0,0,1,1
"Gutierrez-Sacristan, A",0,0,0,1,1
"Gyang, E",1,0,0,0,1
"Gyrard, A",0,0,0,1,1
"Gómez-Ádrian, J",0,0,0,1,1
"Gött, R",0,0,0,1,1
"Güell, K",0,0,1,0,1
"Ha, E",0,0,1,0,1
"Haam, S",0,0,0,1,1
"Haarbrandt, B",0,0,0,1,1
"Haas, L",0,0,1,0,1
"Haber, R",0,0,0,1,1
"Hadfield, A",0,0,0,1,1
"Hadji, P",0,0,1,0,1
"Haese, T",0,0,0,1,1
"Hahn, W",0,0,0,1,1
"Hakonarson, H",1,0,0,0,1
"Hall, I",0,0,0,1,1
"Hallaj, S",0,0,0,1,1
"Hallgren, K",0,0,1,0,1
"Halpern, Y",0,1,0,0,1
"Hamilton-Lopez, M",0,0,0,1,1
"Hampton, J",0,0,0,1,1
"Han, C",0,0,1,0,1
"Han, J",0,0,0,1,1
"Han, K",0,0,0,1,1
"Han, O",0,0,0,1,1
"Han, S",0,0,1,0,1
"Han, Y",0,0,1,0,1
"Handler, S",0,0,0,1,1
"Hanif, S",0,0,1,0,1
"Hankey, G",0,0,1,0,1
"Hansen, R",1,0,0,0,1
"Haque, S",0,0,1,0,1
"Hardy, C",0,0,1,0,1
"Hardy, D",0,0,0,1,1
"Hardy, N",0,0,0,1,1
"Harle, C",0,0,1,0,1
"Harms, A",0,0,0,1,1
"Harnett, B",0,0,0,1,1
"Harper, J",0,0,1,0,1
"Harrington, L",0,0,1,0,1
"Harrington, R",0,1,0,0,1
"Harris, D",0,1,0,0,1
"Harris, N",0,0,1,0,1
"Hart, G",0,0,0,1,1
"Hartman, P",0,0,0,1,1
"Hartwig, M",1,0,0,0,1
"Harvey, N",0,0,1,0,1
"Hauger, R",0,0,1,0,1
"Hauser, R",0,0,0,1,1
"Havrilla, J",0,0,1,0,1
"Hawk, K",0,0,0,1,1
"Hawley, S",0,0,1,0,1
"Hayes, H",0,0,0,1,1
"Hayn, D",0,1,0,0,1
"He, B",0,0,1,0,1
"He, Z",0,0,0,1,1
"Healey, E",0,0,1,0,1
"Heavner, S",0,0,1,0,1
"Hechtel, N",0,0,0,1,1
"Heckbert, S",1,0,0,0,1
"Hedenmalm, K",0,0,0,1,1
"Hees, H",0,0,0,1,1
"Hein, J",0,0,1,0,1
"Heinemann, L",0,0,1,0,1
"Heinrich, A",0,0,0,1,1
"Heintjes, E",0,0,1,0,1
"Helfer, S",0,1,0,0,1
"Helmkamp, L",0,0,0,1,1
"Hemingway, H",0,0,0,1,1
"Henderson, A",0,1,0,0,1
"Hendricks, B",0,0,1,0,1
"Hengartner, N",0,0,1,0,1
"Heo, E",0,0,1,0,1
"Heo, J",0,0,1,0,1
"Heo, Y",0,0,0,1,1
"Hermann, A",0,0,1,0,1
"Hernández-García, E",0,0,1,0,1
"Hernández-Muñoz, J",0,0,1,0,1
"Herrera, J",0,0,0,1,1
"Herrera, R",0,0,1,0,1
"Herrick, C",0,1,0,0,1
"Herring, S",0,0,1,0,1
"Herrmann, T",0,0,0,1,1
"Hersh, W",0,1,0,0,1
"Hess, G",0,0,1,0,1
"Hesser, J",0,0,0,1,1
"Heudel, P",0,0,1,0,1
"Heuvelink, J",0,0,0,1,1
"Hewa, K",0,0,0,1,1
"Hewitt, K",0,0,0,1,1
"Hill, E",0,0,1,0,1
"Hilton, C",0,0,0,1,1
"Hiltunen, S",0,0,1,0,1
"Hinojosa, E",0,0,0,1,1
"Hinton, W",0,0,0,1,1
"Hirabayashi, K",0,0,1,0,1
"Hoang, U",0,0,1,0,1
"Hochheimer, C",0,0,1,0,1
"Hochheiser, H",0,0,0,1,1
"Hodder, S",0,0,1,0,1
"Hodelin, C",0,0,1,0,1
"Hoelmich, E",0,0,1,0,1
"Hofer, S",0,0,1,0,1
"Hofmann-Apitius, M",0,0,0,1,1
"Hohman, K",0,0,0,1,1
"Holguera, V",0,0,1,0,1
"Holl, R",0,0,1,0,1
"Holleczek, B",1,0,0,0,1
"Holm, J",0,0,0,1,1
"Holub, P",1,0,0,0,1
"Holve, E",0,0,0,1,1
"Hong, C",0,0,1,0,1
"Hong, Y",0,0,1,0,1
"Hopkins, S",0,0,0,1,1
"Horcajada, J",0,0,1,0,1
"Horki, P",0,0,0,1,1
"Horne, B",0,0,1,0,1
"Hornig-Rohan, M",0,0,1,0,1
"Horowitz, C",0,0,1,0,1
"Horswell, R",0,0,0,1,1
"Hosokawa, P",0,0,0,1,1
"Hoti, F",0,0,1,0,1
"Hottgenroth, A",1,0,0,0,1
"Hou, J",1,0,0,0,1
"Hou, L",0,0,0,1,1
"Hough, D",0,0,1,0,1
"Howard, R",0,0,1,0,1
"Howell, K",0,0,0,1,1
"Howsam, G",0,0,1,0,1
"Hrisca, R",0,0,1,0,1
"Hsiao, C",0,0,1,0,1
"Hu, J",1,0,0,0,1
"Hu, W",1,0,0,0,1
"Huang, K",0,0,0,1,1
"Huang, N",0,0,0,1,1
"Huang, Y",1,0,0,0,1
"Huang, Z",0,0,1,0,1
"Huber, A",0,0,0,1,1
"Hudson, C",0,1,0,0,1
"Hui, S",1,0,0,0,1
"Hull, M",0,0,0,1,1
"Hum, R",0,0,1,0,1
"Hume, A",0,0,0,1,1
"Humes, I",0,0,1,0,1
"Hung, A",0,0,1,0,1
"Hung, P",1,0,0,0,1
"Hunger, M",0,0,1,0,1
"Hunt, C",0,0,1,0,1
"Hunter, L",0,0,0,1,1
"Huo, N",0,0,0,1,1
"Hurley, E",0,0,0,1,1
"Hurley, R",0,1,0,0,1
"Husson, J",0,0,0,1,1
"Hwang, G",0,0,1,0,1
"Hwang, Y",1,0,0,0,1
"Händel, M",0,0,1,0,1
"Héja, T",0,0,0,1,1
"Hübner, U",0,0,0,1,1
"Hüsers, J",0,0,0,1,1
"Ibáñez, L",1,0,0,0,1
"Ichihara, M",0,0,0,1,1
"Ide, J",1,0,0,0,1
"Idnay, B",0,1,0,0,1
"Igumba, B",0,0,0,1,1
"Ikeda, Y",0,0,0,1,1
"Ilatovskiy, A",0,0,0,1,1
"Im, G",0,0,1,0,1
"Im, M",0,0,1,0,1
"Imperatore, G",0,0,1,0,1
"Inberg, G",0,1,0,0,1
"Inoue, J",0,0,0,1,1
"Ionita-Laza, I",0,0,1,0,1
"Irwin, J",0,0,1,0,1
"Islam, M",1,0,0,0,1
"Islam, S",0,0,0,1,1
"Ison, H",0,0,1,0,1
"Israni, S",0,1,0,0,1
"Ivaldi, G",0,0,1,0,1
"Iveli, P",0,0,1,0,1
"Iyengar, S",0,1,0,0,1
"Jaarsma, E",0,0,0,1,1
"Jacklin, C",0,0,1,0,1
"Jackson, A",0,0,0,1,1
"Jackson, S",0,0,0,1,1
"Jackson, T",0,0,0,1,1
"Jacobs, J",0,0,0,1,1
"Jacobs, M",0,0,0,1,1
"Jacquemont, C",0,0,0,1,1
"Jacques-Aviñó, C",0,0,1,0,1
"Jacunski, A",1,0,0,0,1
"Jafarpour, M",0,0,0,1,1
"Jafarzadeh, S",0,0,1,0,1
"Jamil, M",0,0,0,1,1
"Jammerbund, B",0,1,0,0,1
"Janetzki, J",0,0,1,0,1
"Jang, I",0,0,0,1,1
"Jang, M",0,0,0,1,1
"Jang, S",0,0,0,1,1
"Jang, W",0,0,1,0,1
"Jani, M",1,0,0,0,1
"Jannot, A",0,0,0,1,1
"Jansen, S",0,0,0,1,1
"Jansen, W",0,0,0,1,1
"Jathissa, P",0,1,0,0,1
"Jaubourg, N",0,0,0,1,1
"Jayaram, R",1,0,0,0,1
"Je, N",0,0,1,0,1
"Jean-Baptiste, L",0,0,0,1,1
"Jeannetot, D",1,0,0,0,1
"Jee, D",0,0,1,0,1
"Jeffery, K",0,0,0,1,1
"Jendrossek, M",0,0,0,1,1
"Jeon, S",0,0,0,1,1
"Jeong, E",0,0,0,1,1
"Jereczek-Fossa, B",0,0,1,0,1
"Jhaveri, K",0,0,1,0,1
"Jiang, J",0,0,1,0,1
"Jiang, Q",1,0,0,0,1
"Jimenez, H",0,0,1,0,1
"Jin, E",0,0,1,0,1
"Jin, K",0,0,1,0,1
"Jin, U",0,0,1,0,1
"Jing, S",0,0,1,0,1
"Jing, Y",0,0,1,0,1
"Jo, Y",0,0,1,0,1
"Joel, M",0,0,1,0,1
"Johanns, O",1,0,0,0,1
"Johnson, M",0,0,1,0,1
"Johnston, J",0,0,0,1,1
"Joiner, E",1,0,0,0,1
"Jolley, S",0,0,1,0,1
"Jones, W",0,0,1,0,1
"Jonker, C",0,0,1,0,1
"Joopudi, V",1,0,0,0,1
"Jorm, L",0,0,0,1,1
"Jose, G",0,0,0,1,1
"Josefsson, A",0,0,1,0,1
"Joshi, N",0,0,0,1,1
"Jouhet, V",0,0,0,1,1
"Jouned, A",0,0,0,1,1
"Journeau, F",0,0,0,1,1
"Joy, G",0,0,0,1,1
"Judge, A",0,0,1,0,1
"Juhlin, K",1,0,0,0,1
"Jung, E",1,0,0,0,1
"Junior, E",0,0,0,1,1
"Justesen, T",0,0,1,0,1
"Justice, A",0,0,0,1,1
"Kabakambira, J",0,0,0,1,1
"Kabano, I",0,0,0,1,1
"Kadioglu, D",0,0,0,1,1
"Kaelber, D",0,0,1,0,1
"Kahlon, M",0,0,1,0,1
"Kahn, C",0,0,0,1,1
"Kajungu, D",0,0,0,1,1
"Kalaw, F",0,0,0,1,1
"Kallout, J",0,0,0,1,1
"Kalsekar, I",0,0,1,0,1
"Kam, H",0,0,0,1,1
"Kamauu, A",0,0,0,1,1
"Kamdje-Wabo, G",0,0,0,1,1
"Kampf, M",0,0,0,1,1
"Kampman, M",0,0,1,0,1
"Kanasaki, K",0,0,1,0,1
"Kanbar, L",0,0,0,1,1
"Kandukuri, P",1,0,0,0,1
"Kaneko, K",0,0,1,0,1
"Kang, B",0,0,0,1,1
"Kang, H",0,0,1,0,1
"Kang, I",0,0,1,0,1
"Kanjilal, S",0,0,1,0,1
"Kanter, A",1,0,0,0,1
"Kao, Y",0,0,0,1,1
"Karafin, M",0,0,0,1,1
"Karatzanis, I",0,0,0,1,1
"Karczewski, K",0,0,0,1,1
"Karimi, L",0,0,1,0,1
"Karimkhani, C",0,0,1,0,1
"Karnes, J",0,0,1,0,1
"Karp, J",0,0,0,1,1
"Kasani, P",0,0,1,0,1
"Kashyap, M",1,0,0,0,1
"Kashyap, R",0,0,1,0,1
"Kasthurirathne, S",1,0,0,0,1
"Katalinic, A",1,0,0,0,1
"Katz, A",0,0,1,0,1
"Kaur, G",0,0,1,0,1
"Kavuluru, R",0,0,1,0,1
"Kean, J",0,0,0,1,1
"Keebler, A",0,0,1,0,1
"Kelbert, P",0,0,0,1,1
"Kelechi, T",0,1,0,0,1
"Keller, M",0,0,0,1,1
"Kelly, W",0,0,1,0,1
"Keloth, V",0,0,0,1,1
"Kempf, E",0,0,0,1,1
"Kempner, M",0,0,1,0,1
"Kennedy, G",0,0,0,1,1
"Kenney, R",0,0,1,0,1
"Kenny, E",0,0,1,0,1
"Kent, D",1,0,0,0,1
"Kerr, W",0,0,0,1,1
"Kersten, O",0,0,0,1,1
"Kesztyüs, D",0,0,0,1,1
"Kesztyüs, T",0,0,0,1,1
"Khalilia, M",0,1,0,0,1
"Khan, A",0,0,0,1,1
"Khan, H",0,0,0,1,1
"Khan, R",0,0,1,0,1
"Khan, U",0,0,1,0,1
"Khanal, A",1,0,0,0,1
"Khanipov, K",0,0,0,1,1
"Kharrazi, H",0,0,0,1,1
"Khayter, M",0,0,0,1,1
"Khilchevskyi, B",0,1,0,0,1
"Khodaverdi, M",0,0,1,0,1
"Khoma, Y",1,0,0,0,1
"Khoshneshin, M",1,0,0,0,1
"Khunti, K",0,0,1,0,1
"Kiadaliri, A",0,0,1,0,1
"Kiederle, J",0,1,0,0,1
"Kieler, C",0,0,0,1,1
"Kimble, W",0,0,1,0,1
"Kimmel, S",0,0,1,0,1
"Kinnaird, A",0,0,1,0,1
"Kirby, J",0,0,1,0,1
"Kirchoff, K",0,0,0,1,1
"Kitzmiller, M",0,0,0,1,1
"Klang, E",0,0,1,0,1
"Klengel, C",0,0,0,1,1
"Klopfenstein, S",0,0,0,1,1
"Kluetz, P",0,0,0,1,1
"Knaack, D",0,0,0,1,1
"Knight, R",0,0,1,0,1
"Knowles, J",0,0,1,0,1
"Ko, H",0,0,1,0,1
"Kodamullil, A",0,0,0,1,1
"Koester, H",0,1,0,0,1
"Kogan, A",0,0,0,1,1
"Kohane, I",0,0,0,1,1
"Kohler, J",0,0,1,0,1
"Kopek, N",0,0,1,0,1
"Korchmar, E",0,1,0,0,1
"Korf, B",0,0,1,0,1
"Korsik, U",1,0,0,0,1
"Korsik, V",0,0,0,1,1
"Kotik, D",0,0,1,0,1
"Kovachev, P",0,0,1,0,1
"Kovesdy, C",0,0,1,0,1
"Kovács, S",0,0,0,1,1
"Kowalski, C",0,0,0,1,1
"Krajenbrink, E",0,0,1,0,1
"Krall, R",0,0,1,0,1
"Krantz, I",0,0,0,1,1
"Kraus, E",0,0,0,1,1
"Kraus, S",0,1,0,0,1
"Krestan, S",0,0,0,1,1
"Krikhely, A",0,0,1,0,1
"Krishnamurthy, A",0,1,0,0,1
"Krishnan, J",0,0,1,0,1
"Krueger, R",0,0,0,1,1
"Krueger, S",0,0,0,1,1
"Krulee, R",0,0,1,0,1
"Krumme, A",0,0,1,0,1
"Ku, C",0,0,0,1,1
"Kuang, Z",1,0,0,0,1
"Kubiak, T",0,0,1,0,1
"Kuhrt, N",0,0,1,0,1
"Kullamaa, L",1,0,0,0,1
"Kumar, P",1,0,0,0,1
"Kumar, V",0,0,1,0,1
"Kuntz, J",0,0,1,0,1
"Kuppelwieser, S",0,0,0,1,1
"Kuria, J",0,0,0,1,1
"Kurki, S",0,0,1,0,1
"Kurth, A",0,0,1,0,1
"Kurtz, M",0,0,0,1,1
"Kury, F",1,0,0,0,1
"Kwack, W",0,0,1,0,1
"Kwan, B",0,0,0,1,1
"Kwon, J",0,0,1,0,1
"Kwon, S",0,0,1,0,1
"Kwong, A",1,0,0,0,1
"Kwong, M",0,0,0,1,1
"Kärcher, F",0,0,0,1,1
"Kümmel, M",0,1,0,0,1
"Künnapuu, K",0,1,0,0,1
"Küstner, E",0,0,1,0,1
"La Ferla, S",0,0,0,1,1
"Ladhani, S",0,0,0,1,1
"Lage-Rupprecht, V",0,0,0,1,1
"Lahousse, L",0,0,1,0,1
"Laht, M",0,0,0,1,1
"Lai, A",0,0,1,0,1
"Lai, E",0,0,0,1,1
"Laleci Erturkmen, G",0,0,0,1,1
"Lambrecht, M",0,0,1,0,1
"Lamonica, S",0,0,1,0,1
"Lamy, J",1,0,0,0,1
"Lang, L",0,0,0,1,1
"Langan, S",0,0,1,0,1
"Langdahl, B",0,0,1,0,1
"Lanzola, G",0,1,0,0,1
"Lara-Corrales, I",0,0,1,0,1
"Laraway, B",1,0,0,0,1
"Lasso, A",0,1,0,0,1
"Laudati, A",0,0,1,0,1
"Laufer, J",0,0,0,1,1
"Lautenbach, E",1,0,0,0,1
"Lauve, N",0,0,1,0,1
"Lavagna, J",0,0,0,1,1
"Lawlor, A",1,0,0,0,1
"Lawrence, E",0,0,0,1,1
"Lawrence-Archer, L",0,0,1,0,1
"Layton, D",0,0,1,0,1
"Lazarevic, M",0,0,1,0,1
"Lazaridis, A",0,0,1,0,1
"LePendu, P",1,0,0,0,1
"Leach, J",0,0,1,0,1
"Leader, J",0,0,1,0,1
"Leblanc, J",0,0,0,1,1
"Lee, B",0,0,1,0,1
"Lee, G",1,0,0,0,1
"Lee, L",0,0,1,0,1
"Lee, M",0,0,1,0,1
"Leeming, G",0,0,0,1,1
"Leeper, N",0,0,1,0,1
"Leese, P",1,0,0,0,1
"Lehne, M",0,0,0,1,1
"Leist, I",0,1,0,0,1
"Lemaitre, G",0,0,0,1,1
"Lembke, A",0,0,1,0,1
"Lemmon, J",0,0,0,1,1
"Lems, W",0,0,1,0,1
"Lenert, L",0,0,0,1,1
"Leng, T",0,0,1,0,1
"Letts, R",1,0,0,0,1
"Leung, C",0,0,1,0,1
"Leung, T",1,0,0,0,1
"Levenson, M",1,0,0,0,1
"Levis, M",0,1,0,0,1
"Levitt, E",0,0,1,0,1
"Levra, N",0,0,1,0,1
"Levy-Clarke, G",0,0,1,0,1
"Li, F",0,0,0,1,1
"Li, H",1,0,0,0,1
"Li, M",0,0,1,0,1
"Lian Duan, L",1,0,0,0,1
"Liang, J",1,0,0,0,1
"Liao, C",0,0,0,1,1
"Liberman, D",0,0,0,1,1
"Liew, J",0,0,1,0,1
"Ligi, K",0,1,0,0,1
"Lim, J",0,0,1,0,1
"Lim, S",0,0,0,1,1
"Lim, Y",0,0,1,0,1
"Lima, D",0,0,0,1,1
"Lin, C",1,0,0,0,1
"Lin, M",0,1,0,0,1
"Lind, J",0,0,1,0,1
"Linden, T",0,0,0,1,1
"Ling, L",0,0,0,1,1
"Lipori, G",0,0,1,0,1
"Litwin, T",0,0,0,1,1
"Liu, D",0,0,1,0,1
"Liu, J",1,0,0,0,1
"Liu, K",0,0,1,0,1
"Liu, W",0,0,1,0,1
"Liu, Z",0,0,0,1,1
"Livartowski, A",0,0,0,1,1
"Lo Re Iii, V",0,0,1,0,1
"Loeffler, M",0,1,0,0,1
"Logier, R",0,0,0,1,1
"Long, C",0,0,0,1,1
"Loperena-Cortes, R",0,0,1,0,1
"Lopez Bernal, J",0,0,1,0,1
"Lopez Montesinos, I",0,0,1,0,1
"Lopez, I",0,0,1,0,1
"Lorenz, S",0,0,0,1,1
"Lou, X",1,0,0,0,1
"Lovis, C",0,0,0,1,1
"Lovrić Makarić, Z",0,0,1,0,1
"Lowe, K",0,0,1,0,1
"Lozinski, G",0,0,0,1,1
"Lu, C",0,0,0,1,1
"Lu, Q",0,0,0,1,1
"Lu, S",0,0,0,1,1
"Lu, Z",0,1,0,0,1
"Luijten, M",0,0,0,1,1
"Lumbers, R",0,0,0,1,1
"Lumley, T",1,0,0,0,1
"Luo, M",0,0,0,1,1
"Luxan, B",0,0,0,1,1
"Luzuriaga, K",0,0,0,1,1
"Ly, N",0,0,1,0,1
"Lynch, J",0,0,0,1,1
"Lyons, R",0,0,0,1,1
"Lysen, T",0,0,1,0,1
"Lyu, H",0,0,0,1,1
"Lyu, K",0,1,0,0,1
"Lähteenmäki, J",0,0,0,1,1
"López, D",0,0,1,0,1
"López, M",0,0,0,1,1
"López-Rueda, A",0,0,0,1,1
"Löbe, M",0,0,0,1,1
"Lübbeke, A",1,0,0,0,1
"M E Nordeng, H",0,0,0,1,1
"Ma, D",0,1,0,0,1
"Ma, J",0,0,1,0,1
"Ma, K",0,0,1,0,1
"Ma, X",0,0,1,0,1
"Maamar, A",0,1,0,0,1
"MacDonald, B",0,1,0,0,1
"MacLeod, R",0,0,0,1,1
"Machnicki, G",1,0,0,0,1
"Machín, A",0,0,0,1,1
"Maclin, R",1,0,0,0,1
"Madhu, S",0,0,1,0,1
"Maertens, J",0,0,0,1,1
"Magel, J",0,0,0,1,1
"Magen-Rimon, R",0,0,1,0,1
"Maglanoc, L",0,0,0,1,1
"Magoc, T",0,0,1,0,1
"Mahoney, K",1,0,0,0,1
"Maidlow, S",0,0,0,1,1
"Mailosi, D",0,0,0,1,1
"Malbrain, M",0,0,1,0,1
"Malcom, B",0,0,0,1,1
"Malicki, C",0,0,0,1,1
"Malin, B",1,0,0,0,1
"Malk, M",0,0,0,1,1
"Mallipattu, S",0,0,1,0,1
"Malone, D",0,0,1,0,1
"Malovini, A",0,0,0,1,1
"Mamidi, T",1,0,0,0,1
"Mandadi, N",0,0,0,1,1
"Mandair, D",1,0,0,0,1
"Mandhadi, V",0,0,0,1,1
"Mandl, K",0,0,0,1,1
"Mangesius, P",0,0,0,1,1
"Manias, G",0,0,0,1,1
"Manion, F",0,1,0,0,1
"Manisty, C",0,0,0,1,1
"Manjourides, J",1,0,0,0,1
"Mansfield, A",1,0,0,0,1
"Mansfield, K",0,0,1,0,1
"Mansouri-Benssassi, E",0,0,0,1,1
"Manuel, W",0,0,0,1,1
"Mao, C",0,0,0,1,1
"Maoyi, M",0,0,0,1,1
"Marcilly, R",0,0,0,1,1
"Marcondes Marcacini, R",0,0,0,1,1
"Marconi, V",0,0,0,1,1
"Marcou, Q",1,0,0,0,1
"Marder, K",0,1,0,0,1
"Mardon, R",0,0,1,0,1
"Maresca, G",0,0,1,0,1
"Margolis, P",0,0,0,1,1
"Margulis, A",0,0,1,0,1
"Marias, K",0,0,0,1,1
"Marinier, K",1,0,0,0,1
"Markham, K",0,0,1,0,1
"Marks, P",0,0,0,1,1
"Marks-Anglin, A",1,0,0,0,1
"Maro, J",0,0,0,1,1
"Marschollek, M",0,0,0,1,1
"Marshall, M",0,0,1,0,1
"Marteau, B",0,0,0,1,1
"Martel, P",0,0,0,1,1
"Martin, D",1,0,0,0,1
"Martin, J",0,0,0,1,1
"Martinez-Laguna, D",0,0,1,0,1
"Martinez-Queipo, M",0,0,0,1,1
"Martró, E",0,0,1,0,1
"Martufi, V",0,0,0,1,1
"Martínez-Sáez, O",0,0,0,1,1
"Mashkoor, M",1,0,0,0,1
"Mata-Castro, N",0,0,1,0,1
"Matentzoglu, N",0,0,0,1,1
"Mateus, P",0,0,0,1,1
"Matharu, G",0,0,1,0,1
"Mathew, J",0,0,0,1,1
"Mathé, E",0,0,1,0,1
"Matos, S",0,0,0,1,1
"Matthewman, J",0,0,1,0,1
"Matthews, J",1,0,0,0,1
"Mawn, L",0,0,1,0,1
"Mayer, P",0,0,0,1,1
"Mayo, K",0,0,1,0,1
"Mayrhofer, M",1,0,0,0,1
"Mazzetti, S",0,0,0,1,1
"Mazzola, R",0,0,1,0,1
"McAllister, G",0,0,0,1,1
"McAteer, H",0,0,1,0,1
"McAuley, A",0,0,0,1,1
"McCarthy, M",0,0,1,0,1
"McClure, R",0,0,0,1,1
"McCoy, D",0,0,1,0,1
"McCrimmon, R",0,0,1,0,1
"McGinley, B",0,0,1,0,1
"McGinnis, K",0,0,0,1,1
"McKeever Bullard, K",0,0,1,0,1
"McKhann, G",1,0,0,0,1
"McLay, B",0,0,0,1,1
"McMahan, G",0,0,0,1,1
"McMahon, A",0,0,0,1,1
"Meacci, F",0,0,1,0,1
"Mecoli, C",0,0,1,0,1
"Medin, J",0,0,1,0,1
"Medina-Peralta, M",0,0,1,0,1
"Medina-Perucha, L",0,0,1,0,1
"Medlock, S",0,0,0,1,1
"Mehta, N",0,0,0,1,1
"Mei, H",0,0,0,1,1
"Meier, A",1,0,0,0,1
"Melancon, B",0,0,0,1,1
"Meler-Claramonte, C",0,0,1,0,1
"Melo, A",0,0,1,0,1
"Mels, G",0,0,0,1,1
"Melton, G",0,0,0,1,1
"Melvin, R",1,0,0,0,1
"Mendez, N",0,0,0,1,1
"Mendonca, E",1,0,0,0,1
"Meng, X",0,0,0,1,1
"Meng, Z",0,0,0,1,1
"Mensch, A",0,0,0,1,1
"Merson, L",0,0,1,0,1
"Messinger, A",0,0,0,1,1
"Meyer, H",0,0,1,0,1
"Miao, S",0,0,1,0,1
"Michael, C",0,0,0,1,1
"Michel, A",1,0,0,0,1
"Middeke, J",0,0,0,1,1
"Miele, L",0,0,0,1,1
"Miguel Mateos Resinas, V",0,0,0,1,1
"Miladinovic, J",0,0,1,0,1
"Miller, J",0,1,0,0,1
"Miller, S",0,0,1,0,1
"Milov, D",0,0,0,1,1
"Miner, A",0,0,1,0,1
"Minisola, S",0,0,1,0,1
"Minter, F",0,1,0,0,1
"Miquel Dominguez, A",0,0,1,0,1
"Mirhaji, P",0,0,1,0,1
"Mishkin, A",0,0,1,0,1
"Mitchell, J",0,0,1,0,1
"Mizuno, A",0,0,1,0,1
"Mo, H",0,1,0,0,1
"Moal, B",0,0,0,1,1
"Modina, E",0,0,0,1,1
"Moelleken, M",0,0,0,1,1
"Moghimi, S",0,0,1,0,1
"Moldwin, Z",0,0,0,1,1
"Moll, K",1,0,0,0,1
"Mollis, B",0,0,1,0,1
"Molokhia, M",1,0,0,0,1
"Momanyi, R",0,0,0,1,1
"Mondorf, A",0,0,0,1,1
"Montagut, N",0,0,1,0,1
"Montalbano, C",0,0,0,1,1
"Montell-Serrano, J",0,0,0,1,1
"Moon, H",0,0,1,0,1
"Moon, J",0,0,0,1,1
"Moon, K",0,0,1,0,1
"Moon, M",0,1,0,0,1
"Moon, S",0,0,1,0,1
"Moonen, J",0,0,0,1,1
"Moores, K",1,0,0,0,1
"Moradi, H",0,0,1,0,1
"Morasek, K",0,0,0,1,1
"Moreau, T",0,0,0,1,1
"Moreno Sierra, J",1,0,0,0,1
"Moreno, J",0,0,1,0,1
"Moreno-Martos, D",0,0,1,0,1
"Morgan, H",0,0,1,0,1
"Morgan, M",0,1,0,0,1
"Moride, Y",1,0,0,0,1
"Morizono, H",0,0,0,1,1
"Morrison, J",0,1,0,0,1
"Morrow, J",0,0,1,0,1
"Morse, K",1,0,0,0,1
"Morton, J",0,0,1,0,1
"Morton, S",1,0,0,0,1
"Mosseveld, B",1,0,0,0,1
"Mottet, N",0,0,1,0,1
"Mouazer, A",0,0,0,1,1
"Mouchet, A",0,0,0,1,1
"Mower, J",1,0,0,0,1
"Mowery, D",0,0,0,1,1
"Mudie, R",0,0,0,1,1
"Muehlendyck, C",0,0,0,1,1
"Mugeni, R",0,0,0,1,1
"Mugotitsa, B",0,0,0,1,1
"Mui, J",0,0,0,1,1
"Mulgrave, J",1,0,0,0,1
"Mulick, A",0,0,1,0,1
"Mullerova, H",0,0,1,0,1
"Mullin, S",0,1,0,0,1
"Mungall, C",0,0,1,0,1
"Munro, K",0,0,0,1,1
"Murad, D",0,0,0,1,1
"Murali, T",1,0,0,0,1
"Murray, D",0,0,0,1,1
"Murray, M",0,0,1,0,1
"Murugesan, S",0,0,0,1,1
"Musanabaganwa, C",0,0,0,1,1
"Muschelli, J",0,0,1,0,1
"Musleh, K",0,0,0,1,1
"Muszynski, J",0,0,1,0,1
"Muñoz Carrero, A",0,0,0,1,1
"Myers, J",0,0,0,1,1
"Myers, K",0,0,1,0,1
"Myers, S",0,0,1,0,1
"Ménager, M",0,0,0,1,1
"Méndez-Boo, L",0,0,0,1,1
"Mészáros, Á",0,0,0,1,1
"Na, H",0,0,0,1,1
"Nadal-Almela, S",0,0,0,1,1
"Naderalvojoud, B",1,0,0,0,1
"Nair, V",1,0,0,0,1
"Nam, K",0,0,0,1,1
"Nam, S",0,0,1,0,1
"Namjou, B",0,0,0,1,1
"Naranjo, A",0,0,1,0,1
"Nasirian, A",0,0,0,1,1
"Natarjan, K",0,0,1,0,1
"Nateghi Haredasht, F",0,0,1,0,1
"Natrajan, K",0,0,1,0,1
"Navarro, A",0,0,0,1,1
"Nazarzadeh, M",0,0,1,0,1
"Nebeker, J",0,0,1,0,1
"Nelson, J",1,0,0,0,1
"Nemati, S",1,0,0,0,1
"Nennecke, A",0,0,0,1,1
"Neo, J",0,0,0,1,1
"Nesmiian, T",0,1,0,0,1
"Nessel, C",1,0,0,0,1
"Neuberg, D",0,0,0,1,1
"Neugut, A",1,0,0,0,1
"Neumaier, M",0,0,0,1,1
"Neumann, A",0,0,1,0,1
"Neumann, D",0,1,0,0,1
"Neves, M",1,0,0,0,1
"Newbern, E",0,0,1,0,1
"Newcomb, C",0,0,1,0,1
"Ng'etich, M",0,0,0,1,1
"Ng, A",0,0,0,1,1
"Ng, D",1,0,0,0,1
"Ng, J",0,0,1,0,1
"Nguyen, Q",1,0,0,0,1
"Nicholson, B",0,0,1,0,1
"Nicklin, S",0,0,0,1,1
"Nieboer, D",0,0,1,0,1
"Nielsen, S",0,0,1,0,1
"Nieri, P",0,0,1,0,1
"Nikai, E",0,0,0,1,1
"Nikiforaki, K",0,0,0,1,1
"Nikolaidis, G",0,0,1,0,1
"Nikolopoulos, S",0,0,1,0,1
"Nind, T",0,0,0,1,1
"Ning, Y",1,0,0,0,1
"Nishimwe, A",0,0,0,1,1
"Nkurikiyeyezu, K",0,0,0,1,1
"Nogues, X",0,0,1,0,1
"Noh, S",0,0,0,1,1
"Nomura, K",0,0,0,1,1
"Nookala, L",0,0,0,1,1
"Nord, M",0,0,1,0,1
"Normando, P",0,0,0,1,1
"Norris, R",0,0,0,1,1
"Northstone, K",0,0,0,1,1
"Noseworthy, P",0,0,0,1,1
"Noshad, M",1,0,0,0,1
"Novelli, N",1,0,0,0,1
"Nsanzimana, S",0,0,0,1,1
"Nudleman, E",0,0,1,0,1
"Nwankwo, V",0,0,1,0,1
"Nybo, M",0,0,1,0,1
"Nzabanita, J",0,0,0,1,1
"Nürnberg, S",0,0,0,1,1
"Nüßler, F",0,0,0,1,1
"O'Brien, W",0,0,1,0,1
"O'Donnell, C",0,0,1,0,1
"O'Donnell, K",0,0,0,1,1
"O'Hanlon, S",0,0,1,0,1
"O'Leary, C",0,0,1,0,1
"Obeid, J",0,0,0,1,1
"Obenchain, R",0,0,1,0,1
"Obene, T",1,0,0,0,1
"Oberprieler, N",0,0,1,0,1
"Oehsen, J",0,0,0,1,1
"Oeltze-Jafra, S",0,0,0,1,1
"Ogunyemi, O",0,0,0,1,1
"Oh, A",0,0,1,0,1
"Oh, M",0,0,1,0,1
"Oh, T",0,0,1,0,1
"Ohmann, C",1,0,0,0,1
"Oikonomou, E",1,0,0,0,1
"Okami, S",0,0,1,0,1
"Okusi, C",0,0,1,0,1
"Oliveira, V",0,0,0,1,1
"Oliver, M",0,0,0,1,1
"Oliver-Garcia, E",0,0,0,1,1
"Ollivere, B",0,0,0,1,1
"Omenn, G",0,0,0,1,1
"Omondi, E",0,0,0,1,1
"Oneta, O",0,0,1,0,1
"Ong, R",0,0,0,1,1
"Oniani, D",0,0,0,1,1
"Oomens, J",0,0,0,1,1
"Oostenbrink, R",0,0,1,0,1
"Opoku-Anane, J",0,0,1,0,1
"Orlova, A",0,0,0,1,1
"Orlova, N",0,0,0,1,1
"Ormiston-Smith, D",0,0,0,1,1
"Orton, C",0,0,0,1,1
"Osborn, D",0,0,1,0,1
"Oskotsky, T",0,0,1,0,1
"Ott, A",0,0,0,1,1
"Ouagne, D",0,0,0,1,1
"Ouazzani, K",0,0,0,1,1
"Overhage, M",1,0,0,0,1
"Owen, R",0,0,0,1,1
"Owoko, H",0,0,0,1,1
"Pablo, R",0,0,0,1,1
"Pacaci, A",0,0,0,1,1
"Pacurariu, A",1,0,0,0,1
"Page, D",1,0,0,0,1
"Pajer, K",0,0,1,0,1
"Pajvani, U",0,0,1,0,1
"Paka, V",0,0,0,1,1
"Palanisamy, S",0,0,1,0,1
"Palmer, N",0,0,0,1,1
"Palmira Amaral, A",0,0,1,0,1
"Paloots, R",0,0,0,1,1
"Pan, Y",0,0,0,1,1
"Panagiotakopoulos, G",0,0,1,0,1
"Panagiotopoulou, M",1,0,0,0,1
"Pang, E",0,0,1,0,1
"Papapostolou, G",0,0,0,1,1
"Pappas, G",0,0,0,1,1
"Pardee, R",0,0,0,1,1
"Parente-Arias, P",0,0,1,0,1
"Parhi, P",0,0,1,0,1
"Pariani, M",0,0,1,0,1
"Parikh, A",0,0,1,0,1
"Parimbelli, E",0,1,0,0,1
"Parizo, J",0,0,1,0,1
"Park, G",1,0,0,0,1
"Parker, C",0,0,0,1,1
"Parmanto, B",0,0,0,1,1
"Parry, J",0,0,1,0,1
"Parsons, M",0,0,0,1,1
"Pasha, A",0,0,1,0,1
"Pasmooij, A",0,0,1,0,1
"Pasquale, M",1,0,0,0,1
"Passey, A",0,0,1,0,1
"Patel, A",0,0,1,0,1
"Patel, B",1,0,0,0,1
"Patel, K",1,0,0,0,1
"Patel, M",0,0,0,1,1
"Patel, P",1,0,0,0,1
"Paterson, J",0,0,1,0,1
"Patibandla, N",0,0,0,1,1
"Paules, C",0,0,1,0,1
"Pav, V",0,0,0,1,1
"Pavkov, M",0,0,1,0,1
"Pawloski, P",0,0,1,0,1
"Payen, A",0,0,0,1,1
"Pazos, A",0,1,0,0,1
"Peck, M",0,0,1,0,1
"Pedregal-Pascual, P",0,0,1,0,1
"Pedrera Jiménez, M",0,0,1,0,1
"Pedrera, M",0,0,0,1,1
"Pedrera-Jiménez, M",0,0,0,1,1
"Pedroso Camargos, A",0,0,1,0,1
"Pedroso, A",0,0,1,0,1
"Pei, Z",0,0,0,1,1
"Peltonen, L",0,0,0,1,1
"Pembroke, C",0,0,1,0,1
"Peng, X",0,1,0,0,1
"Penning-van Beest, F",0,0,1,0,1
"Percha, B",0,1,0,0,1
"Perera, S",0,0,0,1,1
"Perez-Vilar, S",0,0,1,0,1
"Periyakoil, V",1,0,0,0,1
"Perkins, M",0,1,0,0,1
"Perna, M",0,0,1,0,1
"Peters, F",1,0,0,0,1
"Petersen, I",0,0,1,0,1
"Petrone, A",0,0,1,0,1
"Petrović, G",0,0,1,0,1
"Peviani, A",0,0,0,1,1
"Peñafiel Macias, P",0,0,0,1,1
"Pham, H",0,1,0,0,1
"Pham, M",1,0,0,0,1
"Phillips Hey, S",0,0,0,1,1
"Phillips, L",0,1,0,0,1
"Pieper, S",0,1,0,0,1
"Pierce, I",0,0,0,1,1
"Pierre-Jean, M",0,1,0,0,1
"Pigeot, I",0,0,0,1,1
"Pinedo-Villanueva, R",0,0,1,0,1
"Pinheiro, L",1,0,0,0,1
"Pinheiro, S",1,0,0,0,1
"Pinnau, M",0,1,0,0,1
"Pipaliya, R",0,1,0,0,1
"Pires, F",0,0,0,1,1
"Pishko, A",0,0,1,0,1
"Pittman, T",0,1,0,0,1
"Plaikner, S",0,0,0,1,1
"Planat, V",0,0,0,1,1
"Platt, J",0,0,1,0,1
"Platt, R",0,0,0,1,1
"Pliatsika, J",0,0,1,0,1
"Plovnick, R",0,0,0,1,1
"Podchiyska, T",1,0,0,0,1
"Pohrib, S",0,0,1,0,1
"Polce, F",0,1,0,0,1
"Polderman, T",0,0,0,1,1
"Poletti, D",0,0,1,0,1
"Poling, J",0,0,1,0,1
"Polony, V",0,1,0,0,1
"Popham, D",0,0,0,1,1
"Popma, A",0,0,0,1,1
"Porterfield, J",0,0,1,0,1
"Portillo van Diest, A",0,1,0,0,1
"Portillo-Van Diest, A",0,1,0,0,1
"Powell, D",0,0,1,0,1
"Power, L",0,0,0,1,1
"Praet, N",0,0,1,0,1
"Prantl, S",0,1,0,0,1
"Prasad, R",0,0,1,0,1
"Prasser, F",0,1,0,0,1
"Price, B",0,0,1,0,1
"Price, M",0,0,0,1,1
"Priesterroth, L",0,0,1,0,1
"Prieto-Merino, D",1,0,0,0,1
"Prinz, M",0,0,0,1,1
"Prior, F",0,1,0,0,1
"Prodan, B",0,0,0,1,1
"Profili, F",0,0,1,0,1
"Proia, K",0,0,1,0,1
"Przysucha, M",0,0,0,1,1
"Psaty, B",1,0,0,0,1
"Pulgarin, C",0,0,0,1,1
"Pulver, G",0,0,1,0,1
"Pérez Sola, V",0,1,0,0,1
"Pérez-Mitru, A",0,0,1,0,1
"Pérez-Sola, V",0,1,0,0,1
"Pölzl, G",0,1,0,0,1
"Qian, J",0,0,1,0,1
"Qiao, S",0,0,1,0,1
"Qin, Y",0,0,1,0,1
"Qiu, H",0,0,1,0,1
"Qiu, R",0,0,1,0,1
"Quach, J",0,0,0,1,1
"Quaranta, M",0,0,0,1,1
"Quaye, A",0,0,1,0,1
"Quindroit, P",0,0,0,1,1
"Quinnies, K",0,0,1,0,1
"Quiroz, J",0,0,0,1,1
"Quiroz, Y",0,0,1,0,1
"Quon, J",0,0,0,1,1
"Rabasa, G",0,0,1,0,1
"Rader, D",0,0,1,0,1
"Radgoudarzi, N",0,0,0,1,1
"Radha Saseendrakumar, B",0,0,1,0,1
"Rae, A",0,1,0,0,1
"Raebel, M",0,0,0,1,1
"Raffaele Resta, G",0,0,1,0,1
"Rah, Y",0,0,1,0,1
"Rahimi, K",0,0,1,0,1
"Raisaro, J",0,0,0,1,1
"Raja, K",0,0,0,1,1
"Rajagopal, G",0,0,1,0,1
"Ramachandran, K",1,0,0,0,1
"Rambla, J",0,0,0,1,1
"Ramsey-Hardy, C",0,0,0,1,1
"Rana, M",0,0,0,1,1
"Ranade, D",0,0,0,1,1
"Ranallo, P",0,0,0,1,1
"Rance, B",0,0,0,1,1
"Randhawa, G",0,0,1,0,1
"Ranganath, R",1,0,0,0,1
"Rao, P",0,0,0,1,1
"Rao, W",0,0,1,0,1
"Rapisarda, V",0,0,1,0,1
"Raskov, H",0,0,1,0,1
"Rath, N",1,0,0,0,1
"Rathod-Mistry, T",0,0,1,0,1
"Ratwani, S",0,0,0,1,1
"Raumann, B",0,1,0,0,1
"Rausch, K",1,0,0,0,1
"Readhead, B",0,0,1,0,1
"Reckard, A",0,0,1,0,1
"Reedy, C",1,0,0,0,1
"Reel, P",0,0,0,1,1
"Reel, S",0,0,0,1,1
"Reeve, M",1,0,0,0,1
"Regge, D",0,0,0,1,1
"Reilly, G",0,0,0,1,1
"Reilly, M",0,0,1,0,1
"Reiman, E",0,0,1,0,1
"Reis, J",0,1,0,0,1
"Reiter, K",0,0,0,1,1
"Rello, J",0,0,1,0,1
"Ren, L",0,0,1,0,1
"Ren, Y",1,0,0,0,1
"Renata Siimon, Õ",0,0,0,1,1
"Rentko, V",0,0,0,1,1
"Renz, H",0,0,0,1,1
"Resnic, F",0,0,0,1,1
"Reusche, M",0,1,0,0,1
"Reyes Nieva, H",0,0,0,1,1
"Reyes, M",0,0,1,0,1
"Reynolds, C",0,0,0,1,1
"Rhee, Y",1,0,0,0,1
"Rhie, S",0,0,1,0,1
"Rho, H",0,0,1,0,1
"Rho, M",0,1,0,0,1
"Ribeyre, B",0,0,0,1,1
"Richard, J",0,0,1,0,1
"Ricket, I",0,1,0,0,1
"Riedlinger, K",0,0,0,1,1
"Rieux-Laucat, F",0,0,0,1,1
"Rijneek, P",0,0,1,0,1
"Rinaldi, E",0,0,0,1,1
"Ripple, A",1,0,0,0,1
"Rising, S",0,0,0,1,1
"Ritchie, A",0,0,0,1,1
"Ritchie, M",0,0,1,0,1
"Rivera, M",1,0,0,0,1
"Rivera-Sepulveda, A",1,0,0,0,1
"Rjinbeek, P",0,0,1,0,1
"Roadknight, G",0,0,0,1,1
"Robbins, S",0,0,0,1,1
"Roberto, G",0,0,0,1,1
"Robinson, A",1,0,0,0,1
"Robinson, M",0,0,1,0,1
"Robinson, N",0,0,1,0,1
"Robison, B",0,0,0,1,1
"Roboz, G",0,0,0,1,1
"Rocca, M",0,0,0,1,1
"Roderer, N",0,0,0,1,1
"Rodrigues, J",0,0,1,0,1
"Rodrigues-Jr, J",0,0,0,1,1
"Rodriguez, C",0,0,0,1,1
"Rodriguez, D",0,0,1,0,1
"Rodriguez-Molina, D",0,0,1,0,1
"Rodrigáñez, L",0,0,1,0,1
"Roger, J",0,0,1,0,1
"Rogers Driscoll, M",0,0,1,0,1
"Roh, H",0,0,1,0,1
"Roh, S",0,0,1,0,1
"Rohde, C",1,0,0,0,1
"Rohde, J",0,0,1,0,1
"Roig, A",0,0,1,0,1
"Rojas-Carabali, W",0,0,1,0,1
"Rojo, E",0,0,0,1,1
"Rolka, D",0,0,1,0,1
"Romanelli, P",0,0,1,0,1
"Romano, J",1,0,0,0,1
"Romao, L",0,0,0,1,1
"Romio, S",1,0,0,0,1
"Roselló Serrano, À",0,0,1,0,1
"Rosenberg, D",0,0,1,0,1
"Rosenbloom, S",0,0,0,1,1
"Rosenman, M",1,0,0,0,1
"Rosenthal, E",0,0,0,1,1
"Roshdi, M",0,0,0,1,1
"Ross, E",0,0,1,0,1
"Ross, T",0,0,0,1,1
"Rossi, M",0,0,1,0,1
"Rothkötter, H",0,0,0,1,1
"Rothman, R",0,0,1,0,1
"Roumie, C",0,0,1,0,1
"Roupe, G",0,1,0,0,1
"Roux, C",0,0,1,0,1
"Ruan, E",0,0,1,0,1
"Ruan, X",0,0,0,1,1
"Ruber, G",0,0,0,1,1
"Rubio, P",0,0,0,1,1
"Rudisill, P",0,0,0,1,1
"Rudolph, A",0,0,1,0,1
"Rujano, M",1,0,0,0,1
"Runhaar, J",0,0,1,0,1
"Runion, T",0,0,1,0,1
"Ruranga, C",0,0,0,1,1
"Russell, B",0,0,1,0,1
"Russell, S",0,0,1,0,1
"Rutenberg, E",0,1,0,0,1
"Ruth, B",0,0,0,1,1
"Rutter, J",1,0,0,0,1
"Ryang, S",0,0,1,0,1
"Röllig, C",0,0,0,1,1
"Sa, Z",0,0,0,1,1
"Saborit-Torres, J",0,0,0,1,1
"Sacchi, L",0,1,0,0,1
"Sadovy, B",0,0,0,1,1
"Sadowski, K",0,1,0,0,1
"Sadsad, R",0,0,0,1,1
"Saelmans, A",1,0,0,0,1
"Safford, M",0,0,0,1,1
"Sahner, D",1,0,0,0,1
"Sakalis, V",0,0,1,0,1
"Sakilay, S",0,1,0,0,1
"Salamanca, E",0,0,0,1,1
"Salamon, K",1,0,0,0,1
"Salek, S",0,0,1,0,1
"Salles, T",0,0,0,1,1
"Saludes, V",0,0,1,0,1
"Salvador, G",0,0,0,1,1
"Samans, B",0,1,0,0,1
"Sambres, M",1,0,0,0,1
"Samwald, M",0,0,1,0,1
"Sanavia, T",0,0,0,1,1
"Sandberg, L",0,0,1,0,1
"Sandrin, A",0,0,0,1,1
"Santangelo, R",0,0,1,0,1
"Santangelo, S",0,0,1,0,1
"Santos, C",0,0,0,1,1
"Saptono, A",0,0,0,1,1
"Sarachan, B",0,1,0,0,1
"Sarajlić, G",0,0,1,0,1
"Saripalle, R",0,0,0,1,1
"Sarker, S",0,0,0,1,1
"Saroufim, P",1,0,0,0,1
"Sarraju, A",0,0,1,0,1
"Sarrat-González, D",0,1,0,0,1
"Sartori, D",0,0,1,0,1
"Satagopam, V",0,0,0,1,1
"Sauer, B",1,0,0,0,1
"Saunders, G",0,0,0,1,1
"Savage, R",0,0,1,0,1
"Savova, G",0,1,0,0,1
"Sawano, M",0,0,1,0,1
"Sawano, S",0,0,1,0,1
"Sawyer, H",0,0,1,0,1
"Saygin, D",0,0,1,0,1
"Sazo, N",0,0,0,1,1
"Scanga, A",0,0,1,0,1
"Scarnecchia, T",1,0,0,0,1
"Schade, R",0,0,1,0,1
"Schade-Brittinger, C",0,0,0,1,1
"Schaffhauser, B",1,0,0,0,1
"Scheider, S",0,0,0,1,1
"Scheuemie, M",1,0,0,0,1
"Scheumie, M",0,0,1,0,1
"Schiffer-Kane, K",0,0,0,1,1
"Schilder, A",0,0,0,1,1
"Schiphof-Godart, L",1,0,0,0,1
"Schito, M",0,0,1,0,1
"Schiver, E",0,0,0,1,1
"Schlueter, D",0,1,0,0,1
"Schlüter, A",0,0,0,1,1
"Schmid, S",0,0,1,0,1
"Schmidt, F",0,1,0,0,1
"Schmidt, T",0,0,0,1,1
"Schmitz, A",0,0,0,1,1
"Schmücker, P",0,0,0,1,1
"Schnall, R",0,1,0,0,1
"Schram, M",0,0,0,1,1
"Schuff, R",0,0,1,0,1
"Schuler, C",0,0,0,1,1
"Schultz, B",0,0,0,1,1
"Schulz, N",1,0,0,0,1
"Schwalm, M",1,0,0,0,1
"Schwarz, P",0,0,0,1,1
"Schöberl, A",0,0,0,1,1
"Schönfeld, N",0,0,0,1,1
"Schüttler, C",0,1,0,0,1
"Scobbie, D",0,0,0,1,1
"Scorsetti, M",0,0,1,0,1
"Scotti, L",1,0,0,0,1
"Scotti, V",0,0,1,0,1
"Scudeller, L",0,0,0,1,1
"Sebire, N",0,0,0,1,1
"Secora, A",0,0,1,0,1
"Sedki, K",0,0,0,1,1
"Sedlmayr, B",0,1,0,0,1
"Segundo, E",0,0,0,1,1
"Seim, A",0,0,0,1,1
"Selles, R",0,0,1,0,1
"Semakula, M",0,0,0,1,1
"Semple, M",0,0,0,1,1
"Sengupta, S",0,0,1,0,1
"Seo, J",0,0,0,1,1
"Seo, Y",0,0,1,0,1
"Seok, J",0,0,0,1,1
"Seong, J",0,0,0,1,1
"Seong, Y",0,0,0,1,1
"Serper, M",0,0,1,0,1
"Serrano Balazote, P",0,0,1,0,1
"Serrano, P",0,0,0,1,1
"Serrano-Balazote, P",0,0,0,1,1
"Serret-Larmande, A",0,0,0,1,1
"Serve, H",0,0,0,1,1
"Seuchter, S",0,0,0,1,1
"Sevareid-Groth, T",0,0,0,1,1
"Sexton, K",0,1,0,0,1
"Seymour, D",0,0,0,1,1
"Sfakianakis, S",0,0,0,1,1
"Shaddox, T",1,0,0,0,1
"Shah, R",0,1,0,0,1
"Shah, S",0,0,1,0,1
"Shallcross, L",0,0,0,1,1
"Shan, T",0,0,1,0,1
"Shang, Y",0,1,0,0,1
"Shankar, N",0,0,1,0,1
"Shaoibi, A",1,0,0,0,1
"Shapiro, A",0,0,0,1,1
"Sharafeldin, N",0,0,1,0,1
"Sharma, H",0,0,0,1,1
"Sharma, R",0,0,1,0,1
"Shashikumar, S",1,0,0,0,1
"Shaw, A",0,0,1,0,1
"Sheahan, A",0,0,1,0,1
"Sheils, N",1,0,0,0,1
"Shen, F",0,1,0,0,1
"Shen, P",0,0,0,1,1
"Shen, R",1,0,0,0,1
"Shen, Y",0,0,1,0,1
"Sherlock, J",0,0,1,0,1
"Shi, J",0,0,0,1,1
"Shi, W",0,0,0,1,1
"Shields, A",0,0,0,1,1
"Shih, G",0,1,0,0,1
"Shih, M",0,0,1,0,1
"Shih, Y",1,0,0,0,1
"Shin, K",0,0,1,0,1
"Shipherd, J",0,0,1,0,1
"Shoemark, A",0,0,0,1,1
"Shrestha, S",0,0,1,0,1
"Sibert, N",0,0,0,1,1
"Sidhu, S",0,0,1,0,1
"Siebel, J",0,0,0,1,1
"Siegel, K",0,0,1,0,1
"Siew, E",0,0,1,0,1
"Silva, J",0,0,0,1,1
"Silverwood, R",0,0,1,0,1
"Sim, I",0,0,0,1,1
"Simmerling, M",0,0,1,0,1
"Simon, S",1,0,0,0,1
"Simonetti, G",0,0,1,0,1
"Sims, J",0,0,0,1,1
"Sin, M",0,0,0,1,1
"Sinaci, A",0,0,0,1,1
"Sinclair, J",0,0,0,1,1
"Singh, A",0,0,1,0,1
"Singh, J",0,0,1,0,1
"Sippel Schmidt, T",0,0,0,1,1
"Sirota, M",0,0,1,0,1
"Skanderson, M",0,0,0,1,1
"Skidmore, E",0,0,0,1,1
"Skjødt, M",0,0,1,0,1
"Slamanig, G",0,1,0,0,1
"Slattery, J",0,0,0,1,1
"Slaymaker, E",0,0,0,1,1
"Sliz, P",0,0,0,1,1
"Sloan-Murphy, D",0,0,0,1,1
"Smeeth, L",0,0,1,0,1
"Smith, C",0,0,1,0,1
"Smith, G",0,0,1,0,1
"Smith, J",1,0,0,0,1
"Smith, P",0,0,0,1,1
"Smith, S",0,0,0,1,1
"Smith-McLallen, A",0,0,1,0,1
"Smits, E",0,0,1,0,1
"Soares, A",0,0,0,1,1
"Sobel, R",0,0,1,0,1
"Soby, S",0,0,0,1,1
"Soerjomataram, I",0,0,1,0,1
"Soff, J",0,0,0,1,1
"Solbrig, H",0,0,0,1,1
"Soledad Cepeda, M",0,0,0,1,1
"Solomonides, A",1,0,0,0,1
"Solovyev, P",0,0,0,1,1
"Son, D",0,0,0,1,1
"Sonawane, K",1,0,0,0,1
"Song, M",0,0,0,1,1
"Song, Q",0,0,1,0,1
"Sorbello, A",1,0,0,0,1
"Sorlí Redó, L",0,0,1,0,1
"South, A",0,0,0,1,1
"South, B",0,0,0,1,1
"Southard, C",0,1,0,0,1
"Southwell, B",0,0,0,1,1
"Spalding, J",0,0,0,1,1
"Spasic, D",0,0,1,0,1
"Spital, C",0,1,0,0,1
"Spolti, A",0,0,1,0,1
"Spotniz, M",0,0,1,0,1
"Spriggs, R",0,0,0,1,1
"Springer, C",0,0,1,0,1
"Springstubbe, S",0,0,0,1,1
"Sproviero, W",0,0,1,0,1
"Srisuwananukorn, A",0,0,0,1,1
"Staab, J",0,0,0,1,1
"Staeubert, S",0,1,0,0,1
"Stagg, B",0,0,0,1,1
"Stahl, C",0,0,1,0,1
"Starren, J",0,0,0,1,1
"Steele, D",0,0,0,1,1
"Stefanski, A",0,0,0,1,1
"Steiner, C",0,0,1,0,1
"Steiner, J",0,0,0,1,1
"Steinmeyer, J",0,0,0,1,1
"Stipancic, A",0,0,0,1,1
"Stocking, J",0,0,1,0,1
"Stone, D",0,0,0,1,1
"Stovall, R",0,0,1,0,1
"Strantz, C",0,1,0,0,1
"Street, W",1,0,0,0,1
"Struebing, A",0,1,0,0,1
"Stuppia, M",0,1,0,0,1
"Stuvek, B",0,0,1,0,1
"Su, J",0,0,1,0,1
"Subramanian, D",1,0,0,0,1
"Suehs, B",1,0,0,0,1
"Suh, H",0,0,1,0,1
"Sullivan, C",0,0,0,1,1
"Sun, D",0,0,1,0,1
"Sun, J",0,1,0,0,1
"Sung, L",0,0,0,1,1
"Sung, M",1,0,0,0,1
"Sunshine, J",0,0,1,0,1
"Surampalli, S",0,0,0,1,1
"Suresh, S",0,0,1,0,1
"Suruki, R",0,0,1,0,1
"Sutherland, J",0,0,0,1,1
"Suver, C",0,0,0,1,1
"Suzuki, A",0,0,1,0,1
"Sweeney, B",0,0,0,1,1
"Sweeney, T",1,0,0,0,1
"Syed, M",0,1,0,0,1
"Syed, S",0,1,0,0,1
"Syeda, H",0,1,0,0,1
"Szarfman, A",0,0,0,1,1
"Szczepanski, P",0,0,0,1,1
"Sánchez Barrueco, Á",0,0,1,0,1
"Sánchez-Martín, J",0,0,1,0,1
"Sánchez-Pla, A",1,0,0,0,1
"Séité, T",0,1,0,0,1
"Tabuenca, J",1,0,0,0,1
"Tachos, N",0,0,0,1,1
"Tadrous, M",0,0,1,0,1
"Taghizadeh, E",0,0,0,1,1
"Tahseen, D",0,0,0,1,1
"Tai, E",0,0,0,1,1
"Takkouche, S",0,0,1,0,1
"Talapova, P",0,1,0,0,1
"Tan, A",0,0,0,1,1
"Tan, D",0,0,0,1,1
"Taneja, S",0,0,0,1,1
"Tang, L",0,0,1,0,1
"Tang, M",0,0,0,1,1
"Tang, Y",0,1,0,0,1
"Tanjga, N",0,0,0,1,1
"Tao, C",0,0,0,1,1
"Taraborrelli, M",0,0,1,0,1
"Tarczy-Hornoch, P",0,1,0,0,1
"Tate, J",0,0,0,1,1
"Tate, S",0,0,1,0,1
"Tato, J",0,0,1,0,1
"Tavakoli, K",0,0,0,1,1
"Taylor, D",0,1,0,0,1
"Taylor, P",0,0,1,0,1
"Tchertov, J",0,0,0,1,1
"Tebé, C",0,0,1,0,1
"Teeter, B",1,0,0,0,1
"Tenenbaum, J",0,0,0,1,1
"Teo, D",0,0,0,1,1
"Terao, S",0,0,0,1,1
"Teviotdale, R",0,0,0,1,1
"Thacker, D",0,0,1,0,1
"Thackeray, A",0,0,0,1,1
"Thakoor, K",0,0,0,1,1
"Thangraraj, P",0,0,1,0,1
"The Vebis Hcw Ve Study Group, NA",0,0,1,0,1
"Theodoratou, E",0,0,0,1,1
"Theron, E",0,0,0,1,1
"Thollot, R",0,0,0,1,1
"Thomas, J",0,0,1,0,1
"Thomas, M",0,0,1,0,1
"Thomas, N",0,0,1,0,1
"Thomas, T",0,0,1,0,1
"Thompson, A",0,0,0,1,1
"Thoral, P",0,1,0,0,1
"Thygesen, J",0,0,1,0,1
"Tibollo, V",0,0,0,1,1
"Tieskens, J",0,0,0,1,1
"Tignanelli, C",0,0,0,1,1
"Tilston, G",0,0,0,1,1
"Tjoa, M",0,0,1,0,1
"Tobed, M",0,0,1,0,1
"Tomasini, D",0,0,1,0,1
"Tomlin, K",0,0,0,1,1
"Tomlinson, C",0,0,1,0,1
"Torabi, F",0,0,0,1,1
"Tortopidis, G",0,0,0,1,1
"Touré, V",0,0,0,1,1
"Traina, A",0,0,0,1,1
"Trama, A",0,0,1,0,1
"Tramma, L",0,0,0,1,1
"Tran, D",0,0,1,0,1
"Tran, T",0,1,0,0,1
"Tran-Nguyen, T",1,0,0,0,1
"Tremblay, D",0,0,0,1,1
"Triggiani, L",0,0,1,0,1
"Trinkley, K",0,0,0,1,1
"Tripathy, M",0,0,1,0,1
"Trofymenko, M",0,1,0,0,1
"Trucco, E",0,0,0,1,1
"Tryfinopoulou, K",0,0,1,0,1
"Trübe, L",0,0,0,1,1
"Tsakou, G",1,0,0,0,1
"Tsang, R",0,0,0,1,1
"Tsapepas, D",0,0,0,1,1
"Tsopra, R",0,0,0,1,1
"Tsou, C",1,0,0,0,1
"Tucker, E",0,0,0,1,1
"Turkmen, C",0,0,1,0,1
"Twizere, C",0,0,0,1,1
"Törnroos, J",0,0,0,1,1
"Uhrich, C",0,0,0,1,1
"Unberath, P",0,0,0,1,1
"Urdiales, T",0,0,1,0,1
"Uribe, A",0,0,1,0,1
"Uribe, S",0,0,0,1,1
"Ussing, A",0,0,1,0,1
"Utumatwishima, J",0,0,0,1,1
"Uwimana, A",0,0,0,1,1
"Uwineza, A",0,0,0,1,1
"V Patterson, O",0,0,0,1,1
"Vacchi, E",0,0,0,1,1
"Valadas Henriques, C",0,0,1,0,1
"Valdes, A",0,0,0,1,1
"Valentine, S",1,0,0,0,1
"Vallet, B",0,0,0,1,1
"Van Der Vegt, A",0,0,0,1,1
"Van Der Zwan, E",0,0,0,1,1
"Van Winzum, A",0,0,0,1,1
"Van den Bergh, R",0,0,1,0,1
"Vance, L",0,0,1,0,1
"Vandenberghe, F",0,0,1,0,1
"Vandromme, M",0,0,1,0,1
"Vangala, U",0,0,0,1,1
"Vanitchanant, N",1,0,0,0,1
"Varkhedi, V",0,0,1,0,1
"Varley, T",0,0,0,1,1
"Varma, S",0,0,0,1,1
"Varoquaux, G",0,0,0,1,1
"Varrassi, G",0,0,1,0,1
"Vasallo, C",0,0,0,1,1
"Vasilevsky, N",0,0,0,1,1
"Vatani, H",0,0,0,1,1
"Veal, C",0,0,0,1,1
"Ved, M",0,1,0,0,1
"Vehkala, M",0,0,1,0,1
"Velarde, L",0,0,1,0,1
"Velez, M",0,1,0,0,1
"Veljkovic, N",0,0,1,0,1
"Vengadeswaran, A",0,0,0,1,1
"Venkatesh, A",0,0,0,1,1
"Verdy, G",1,0,0,0,1
"Verloop, D",0,0,0,1,1
"Verma, A",0,0,1,0,1
"Verweij, S",0,0,1,0,1
"Vest, M",0,0,1,0,1
"Vettese, E",0,0,0,1,1
"Victor, W",0,0,1,0,1
"Vidal, A",0,0,0,1,1
"Vidlin, S",0,0,1,0,1
"Vie, J",0,0,0,1,1
"Vieland, V",0,0,0,1,1
"Vikhrak, M",0,1,0,0,1
"Vilaseca, I",0,0,1,0,1
"Villacampa, J",0,0,1,0,1
"Villarraga, V",0,0,1,0,1
"Visani, L",0,0,1,0,1
"Visca, M",0,0,1,0,1
"Vivekanantham, A",0,0,1,0,1
"Vogelsang, R",0,0,1,0,1
"Volpe, S",0,0,1,0,1
"Volynski, M",0,0,0,1,1
"Vora, P",0,0,1,0,1
"Vorisek, C",0,0,0,1,1
"Vormstein, P",0,0,0,1,1
"Vujovic, A",0,0,1,0,1
"Wadwa, P",0,0,1,0,1
"Wadwa, R",0,0,1,0,1
"Wagener, H",1,0,0,0,1
"Wagholikar, K",0,1,0,0,1
"Wagner, H",0,0,0,1,1
"Walker, A",1,0,0,0,1
"Walker, M",0,0,0,1,1
"Wallace, R",0,0,0,1,1
"Wallace, S",0,0,0,1,1
"Waltemath, D",0,0,0,1,1
"Walters, S",0,0,0,1,1
"Wan, Y",0,0,0,1,1
"Wand, H",0,0,1,0,1
"Wang, K",0,0,1,0,1
"Wang, M",0,0,0,1,1
"Wang, N",0,0,0,1,1
"Wang, Q",1,0,0,0,1
"Wang, R",0,0,1,0,1
"Ward, H",0,0,0,1,1
"Wardi, G",1,0,0,0,1
"Wareham, N",0,0,1,0,1
"Wassermann, D",0,0,0,1,1
"Wattacheril, J",0,0,1,0,1
"Weatherston, D",0,0,0,1,1
"Weber, G",0,0,0,1,1
"Weber, I",0,0,1,0,1
"Webster-Clark, M",0,0,0,1,1
"Weeks, J",0,0,0,1,1
"Weemers, J",0,0,1,0,1
"Wegner, P",0,0,0,1,1
"Wei, Y",1,0,0,0,1
"Weibel, D",1,0,0,0,1
"Weiner, S",0,0,0,1,1
"Weiss, A",1,0,0,0,1
"Weiss, B",0,0,1,0,1
"Weisshof, R",0,0,1,0,1
"Wen, B",0,0,1,0,1
"Wen, C",0,1,0,0,1
"Wendl, C",0,0,0,1,1
"Wentworth, C",0,0,0,1,1
"Werner, R",1,0,0,0,1
"West, D",0,0,0,1,1
"West, I",0,0,1,0,1
"Westen, S",0,0,1,0,1
"Westhoff, C",0,0,1,0,1
"Westrich, K",1,0,0,0,1
"Wetherill, G",0,0,0,1,1
"Whalen, E",1,0,0,0,1
"Whitaker, M",0,0,0,1,1
"White, T",0,0,0,1,1
"Whitehouse, M",0,0,1,0,1
"Widschwendter, M",0,0,0,1,1
"Wiederhold, A",1,0,0,0,1
"Wiesmüller, F",0,1,0,0,1
"Wilde, M",0,0,1,0,1
"Wilemon, K",0,0,1,0,1
"Wiley, L",0,0,0,1,1
"Wilhelm, M",0,0,0,1,1
"Wilk, S",0,0,0,1,1
"Wilkins, K",1,0,0,0,1
"Willame, C",0,0,1,0,1
"Williams, N",0,0,0,1,1
"Wilson, J",0,1,0,0,1
"Wilson, O",0,0,1,0,1
"Wing, Y",0,0,1,0,1
"Winnenburg, R",1,0,0,0,1
"Winter, A",0,0,0,1,1
"Wirth, F",0,1,0,0,1
"Wolf, B",0,0,0,1,1
"Wolock, C",1,0,0,0,1
"Wolters, F",0,0,0,1,1
"Wong, R",1,0,0,0,1
"Wood, A",0,0,1,0,1
"Wood, I",0,0,1,0,1
"Wood, W",0,0,0,1,1
"Woodcock, J",1,0,0,0,1
"Wormald, J",0,0,1,0,1
"Worthey, E",1,0,0,0,1
"Wu, F",0,0,1,0,1
"Wu, H",0,0,0,1,1
"Wu, J",0,0,1,0,1
"Wu, P",0,0,0,1,1
"Wu, W",0,0,0,1,1
"Wulff, R",0,0,0,1,1
"Wyrwa, J",0,0,0,1,1
"Xiao, G",0,0,0,1,1
"Xiao, X",1,0,0,0,1
"Xing, F",0,0,1,0,1
"Xing, Y",0,0,1,0,1
"Xu, C",1,0,0,0,1
"Xu, J",0,1,0,0,1
"Yadavalli, M",0,0,1,0,1
"Yahi, A",0,0,1,0,1
"Yamashita, S",0,0,1,0,1
"Yamashita, T",0,0,0,1,1
"Yan, C",1,0,0,0,1
"Yan, Y",0,0,1,0,1
"Yang, D",0,0,1,0,1
"Yang, P",0,0,0,1,1
"Yang, Q",0,0,0,1,1
"Yang, X",0,0,1,0,1
"Yannicelli, D",1,0,0,0,1
"Ye, Y",0,1,0,0,1
"Yee, J",0,0,1,0,1
"Yen, S",0,0,1,0,1
"Yeow, J",0,0,1,0,1
"Yi, H",0,1,0,0,1
"Yi, K",0,0,1,0,1
"Yi, W",0,0,1,0,1
"Yi, Y",0,0,1,0,1
"Yilmaz, B",0,0,1,0,1
"Yimer, B",0,0,1,0,1
"Yin Hui Lai, L",0,0,1,0,1
"Yin, Y",0,0,1,0,1
"Yoo, H",0,0,0,1,1
"Yoon, K",0,0,0,1,1
"Yoshikawa-Ryan, K",0,0,1,0,1
"Yu, F",0,0,0,1,1
"Yu, H",0,0,1,0,1
"Yu, L",1,0,0,0,1
"Yu, T",1,0,0,0,1
"Yuan, Q",0,0,1,0,1
"Yue, Y",1,0,0,0,1
"Yuen-Chun Teoh, J",1,0,0,0,1
"Yuksel, M",0,0,0,1,1
"Yum, S",0,0,1,0,1
"Yun, J",0,0,0,1,1
"Zachariadou, M",0,0,1,0,1
"Zachariah, P",0,0,1,0,1
"Zahid, J",0,0,1,0,1
"Zahner, J",0,0,0,1,1
"Zai, A",0,0,0,1,1
"Zambarano, B",0,0,0,1,1
"Zambelli, A",0,0,0,1,1
"Zambon, M",0,0,1,0,1
"Zanetti, I",0,0,1,0,1
"Zangwill, L",0,0,0,1,1
"Zeger, S",0,0,1,0,1
"Zeimpekis, D",0,0,0,1,1
"Zekarias, A",0,0,1,0,1
"Zelnis, J",0,1,0,0,1
"Zemplényi, A",0,0,0,1,1
"Zeng, P",1,0,0,0,1
"Zhai, C",0,0,1,0,1
"Zhang, J",0,0,1,0,1
"Zhang, M",0,0,0,1,1
"Zhang, N",0,0,0,1,1
"Zhang, P",0,1,0,0,1
"Zhang, W",0,0,1,0,1
"Zhao, B",0,0,0,1,1
"Zhao, J",0,0,0,1,1
"Zhen, W",0,0,1,0,1
"Zheng, J",0,0,0,1,1
"Zhong, Y",0,0,0,1,1
"Zhou, F",0,0,0,1,1
"Zhou, L",1,0,0,0,1
"Zhu, D",0,0,1,0,1
"Zhuk, A",1,0,0,0,1
"Ziegl, A",0,0,0,1,1
"Zijlmans, J",0,0,0,1,1
"Zisser, M",1,0,0,0,1
"Zonfrillo, M",0,0,1,0,1
"Zong, J",1,0,0,0,1
"Zou, Y",1,0,0,0,1
"Zounemat Kermani, N",0,0,1,0,1
"Zrounba, P",0,0,1,0,1
"Zöller, D",0,1,0,0,1
"Zúquete, A",0,1,0,0,1
"da Silva, H",0,0,1,0,1
"de Abreu Moreira, D",0,0,0,1,1
"de Barros Vanzin, V",0,0,0,1,1
"de Cid, R",0,0,0,1,1
"de Sousa, F",0,0,0,1,1
"de Veer, B",0,1,0,0,1
"de Vogel, S",0,0,1,0,1
"den Otter, S",0,1,0,0,1
"van Baalen, V",0,0,1,0,1
"van Ballegooijen, H",0,0,1,0,1
"van Beek, E",0,0,0,1,1
"van Klaveren, D",1,0,0,0,1
"van Oers, H",0,0,0,1,1
"van Vaerenbergh, F",0,0,1,0,1
"van der Doelen, D",0,0,0,1,1
"van der Graaff, F",0,0,0,1,1
"van der Landen, S",0,0,0,1,1
"von Bülow, C",0,0,1,0,1
"von Gerich, H",0,0,0,1,1
"von Ziegenweidt, J",0,0,0,1,1
"Åsvold, B",0,0,1,0,1
"Österle, S",0,0,0,1,1
"Østby, J",0,0,0,1,1
"Ückert, F",0,0,0,1,1
"Üresin, A",0,0,1,0,1
"Ćwiek-Kupczyńska, H",0,0,0,1,1
"Şen, S",0,0,1,0,1
